//MAP CONVERTED BY dmm2tgm.py THIS HEADER COMMENT PREVENTS RECONVERSION, DO NOT REMOVE
"am" = (
/obj/structure/halflife/storage/large/shelf,
/turf/open/floor/plating/indoor/concrete/bricks,
/area/deathmatch)
"aH" = (
/turf/open/floor/plating/ground/dirt/alt,
/area/deathmatch)
"aV" = (
/obj/machinery/light/small{
	dir = 8
	},
/turf/open/floor/plating/indoor/woodc/wide,
/area/deathmatch)
"bq" = (
/turf/closed/indestructible/riveted,
/area/deathmatch)
"bB" = (
/turf/open/floor/plating/ground/sidewalk/inner,
/area/deathmatch)
"bD" = (
/turf/open/floor/plating/indoor/carpet,
/area/deathmatch)
"bI" = (
/obj/machinery/light/small{
	dir = 1
	},
/turf/open/floor/plating/indoor/concrete/bricks,
/area/deathmatch)
"bZ" = (
/turf/open/floor/plating/indoor/woodc/wide,
/area/deathmatch)
"cg" = (
/obj/structure/halflife/barrel/double/grey/one,
/turf/open/floor/plating/indoor/concrete/bricks,
/area/deathmatch)
"cF" = (
/obj/structure/flora/bush/fullgrass/style_random,
/turf/open/floor/plating/ground/dirt,
/area/deathmatch)
"cZ" = (
/obj/structure/flora/bush/fullgrass/style_random,
/turf/open/misc/grass/jungle/station,
/area/deathmatch)
"dF" = (
/obj/structure/closet/secure_closet/freezer,
/turf/open/floor/plating/indoor/checkered,
/area/deathmatch)
"dP" = (
/obj/structure/flora/bush/sparsegrass/style_random,
/turf/open/floor/plating/ground/dirt,
/area/deathmatch)
"em" = (
/obj/structure/halflife/tank/chemical/container,
/turf/open/floor/plating/indoor/metal/pipe{
	dir = 1
	},
/area/deathmatch)
"eW" = (
/obj/structure/bed/halflife/bedframe/cot,
/obj/structure/bed/halflife/mattress/yellowed,
/turf/open/floor/plating/indoor/carpet,
/area/deathmatch)
"fw" = (
/turf/open/floor/plating/ground/dirt,
/area/deathmatch)
"gh" = (
/obj/structure/halflife/tank/chemical/huge,
/turf/open/floor/plating/indoor/metal/pipe{
	dir = 1
	},
/area/deathmatch)
"gB" = (
/turf/open/floor/plating/indoor/metal/pipe,
/area/deathmatch)
"hd" = (
/obj/structure/flora/bush/sparsegrass/style_random,
/turf/open/misc/grass/jungle/station,
/area/deathmatch)
"hi" = (
/obj/structure/flora/tree/jungle/small,
/turf/open/floor/plating/ground/dirt,
/area/deathmatch)
"ip" = (
/turf/open/floor/plating/indoor/metal/pipe/corner{
	dir = 1
	},
/area/deathmatch)
"jM" = (
/obj/effect/landmark/deathmatch_player_spawn,
/turf/open/floor/plating/indoor/concrete/bricks,
/area/deathmatch)
"lc" = (
/obj/effect/landmark/deathmatch_player_spawn,
/turf/open/floor/plating/ground/sidewalk,
/area/deathmatch)
"lZ" = (
/obj/machinery/light/small{
	dir = 4
	},
/obj/effect/landmark/deathmatch_player_spawn,
/turf/open/floor/plating/ground/sidewalk,
/area/deathmatch)
"mp" = (
/obj/effect/landmark/deathmatch_player_spawn,
/turf/open/floor/plating/ground/sidewalk/inner,
/area/deathmatch)
"mI" = (
/obj/machinery/door/unpowered/halflife/wood,
/turf/open/floor/plating/indoor/concrete/bricks,
/area/deathmatch)
"ne" = (
/obj/structure/table/halflife/no_smooth/wood/stand,
/turf/open/floor/plating/indoor/carpet,
/area/deathmatch)
"nv" = (
/obj/structure/halflife/barrel/triple/grey,
/turf/open/floor/plating/indoor/concrete/bricks,
/area/deathmatch)
"pl" = (
/obj/machinery/light/small{
	dir = 1
	},
/turf/open/floor/plating/indoor/woodc/wide,
/area/deathmatch)
"qq" = (
/obj/structure/halflife/trash/garbage,
/turf/open/floor/plating/ground/sidewalk/inner,
/area/deathmatch)
"sj" = (
/obj/structure/halflife/trash/cardboard,
/turf/open/floor/plating/indoor/woodc/wide,
/area/deathmatch)
"sp" = (
/obj/structure/halflife/trash/cardboard,
/turf/open/floor/plating/indoor/concrete/bricks,
/area/deathmatch)
"sN" = (
/turf/open/floor/plating/indoor/metal/plate,
/area/deathmatch)
"tK" = (
/obj/structure/halflife/pallet/stack,
/turf/open/floor/plating/indoor/metal/plate,
/area/deathmatch)
"tL" = (
/obj/structure/halflife/barrel/triple/red/one,
/turf/open/floor/plating/indoor/concrete/bricks,
/area/deathmatch)
"uj" = (
/obj/structure/halflife/barrel/triple/grey,
/turf/open/floor/plating/indoor/metal/plate,
/area/deathmatch)
"uE" = (
/obj/machinery/light/small{
	dir = 8
	},
/turf/open/floor/plating/ground/dirt,
/area/deathmatch)
"vv" = (
/obj/structure/halflife/trash/garbage,
/turf/open/misc/grass/jungle/station,
/area/deathmatch)
"vY" = (
/obj/machinery/light/small{
	dir = 1
	},
/turf/open/floor/plating/ground/sidewalk/inner,
/area/deathmatch)
"wb" = (
/obj/structure/halflife/trash/garbage,
/turf/open/floor/plating/ground/dirt/alt,
/area/deathmatch)
"wd" = (
/obj/structure/flora/tree/jungle/small,
/turf/open/misc/grass/jungle/station,
/area/deathmatch)
"wG" = (
/obj/machinery/light/small{
	dir = 1
	},
/turf/open/floor/plating/indoor/checkered,
/area/deathmatch)
"xl" = (
/obj/machinery/light/small,
/turf/open/floor/plating/ground/sidewalk/inner,
/area/deathmatch)
"xC" = (
/obj/structure/halflife/trash/papers/two,
/turf/open/floor/plating/indoor/woodc/wide,
/area/deathmatch)
"yg" = (
/obj/machinery/light/small{
	dir = 4
	},
/turf/open/floor/plating/indoor/metal/plate,
/area/deathmatch)
"yh" = (
/obj/effect/landmark/deathmatch_player_spawn,
/turf/open/floor/plating/indoor/woodc/wide,
/area/deathmatch)
"yp" = (
/turf/open/floor/plating/indoor/checkered,
/area/deathmatch)
"yq" = (
/obj/machinery/light/small{
	dir = 8
	},
/turf/open/floor/plating/ground/sidewalk/inner,
/area/deathmatch)
"Aw" = (
/obj/effect/landmark/deathmatch_player_spawn,
/obj/machinery/light/small,
/turf/open/floor/plating/indoor/metal/plate,
/area/deathmatch)
"BU" = (
/turf/open/floor/plating/indoor/concrete/bricks,
/area/deathmatch)
"Ci" = (
/obj/structure/halflife/trash/garbage,
/turf/open/floor/plating/indoor/concrete/bricks,
/area/deathmatch)
"Ds" = (
/obj/machinery/door/unpowered/halflife/wood,
/turf/open/floor/plating/indoor/woodc/wide,
/area/deathmatch)
"Dt" = (
/obj/machinery/light/small{
	dir = 4
	},
/turf/open/floor/plating/ground/sidewalk/inner,
/area/deathmatch)
"Ed" = (
/obj/structure/halflife/pallet,
/turf/open/floor/plating/indoor/metal/plate,
/area/deathmatch)
"EJ" = (
/obj/machinery/light/small{
	dir = 8
	},
/turf/open/floor/plating/indoor/metal/plate,
/area/deathmatch)
"EV" = (
/obj/structure/table/halflife/no_smooth/wood/stand,
/obj/structure/halflife/trash/food/misc,
/turf/open/floor/plating/indoor/carpet,
/area/deathmatch)
"FS" = (
/obj/structure/closet/crate/bin,
/turf/open/floor/plating/ground/sidewalk/inner,
/area/deathmatch)
"GG" = (
/obj/structure/halflife/trash/garbage,
/turf/open/floor/plating/ground/dirt,
/area/deathmatch)
"GP" = (
/obj/structure/halflife/pallet/stack,
/turf/open/floor/plating/indoor/concrete/bricks,
/area/deathmatch)
"Hd" = (
/obj/machinery/light/small{
	dir = 4
	},
/turf/open/floor/plating/indoor/woodc/wide,
/area/deathmatch)
"HN" = (
/obj/machinery/power/halflife/streetlamp{
	dir = 4
	},
/turf/open/floor/plating/ground/dirt,
/area/deathmatch)
"IR" = (
/obj/structure/halflife/storage/large/clothing,
/turf/open/floor/plating/indoor/woodc/wide,
/area/deathmatch)
"IU" = (
/obj/machinery/light/small,
/turf/open/floor/plating/indoor/woodc/wide,
/area/deathmatch)
"Jm" = (
/obj/machinery/light/small{
	dir = 4
	},
/turf/open/floor/plating/ground/dirt,
/area/deathmatch)
"JM" = (
/obj/machinery/door/unpowered/halflife/wood{
	dir = 8
	},
/turf/open/floor/plating/indoor/woodc/wide,
/area/deathmatch)
"JU" = (
/obj/structure/window/fulltile,
/turf/open/floor/plating/indoor/metal/plate,
/area/deathmatch)
"JV" = (
/turf/open/floor/plating/indoor/metal/pipe/intersection{
	dir = 1
	},
/area/deathmatch)
"Kz" = (
/turf/open/misc/grass/jungle/station,
/area/deathmatch)
"KY" = (
/obj/machinery/light/small{
	dir = 8
	},
/turf/open/floor/plating/indoor/concrete/bricks,
/area/deathmatch)
"LS" = (
/obj/structure/table/halflife/no_smooth/large/wood/square{
	dir = 1
	},
/obj/structure/halflife/trash/food/misc,
/obj/machinery/light/small{
	dir = 8
	},
/turf/open/floor/plating/indoor/checkered,
/area/deathmatch)
"Mf" = (
/obj/structure/halflife/barrel/triple/red/two,
/turf/open/floor/plating/indoor/concrete/bricks,
/area/deathmatch)
"Nb" = (
/obj/structure/halflife/barrel/double/grey/two,
/turf/open/floor/plating/indoor/concrete/bricks,
/area/deathmatch)
"NS" = (
/obj/structure/halflife/pallet,
/turf/open/floor/plating/indoor/concrete/bricks,
/area/deathmatch)
"Or" = (
/turf/open/floor/plating/indoor/metal/pipe{
	dir = 1
	},
/area/deathmatch)
"Oy" = (
/obj/structure/halflife/storage/large/shelf/wood,
/turf/open/floor/plating/indoor/woodc/wide,
/area/deathmatch)
"OA" = (
/obj/structure/halflife/barrel/quadruple/grey/one,
/turf/open/floor/plating/indoor/concrete/bricks,
/area/deathmatch)
"OL" = (
/obj/machinery/power/halflife/streetlamp{
	dir = 8
	},
/turf/open/floor/plating/ground/dirt,
/area/deathmatch)
"QO" = (
/turf/closed/wall/halflife/brick,
/area/deathmatch)
"QT" = (
/obj/structure/window/fulltile,
/turf/open/floor/plating/indoor/concrete/bricks,
/area/deathmatch)
"Rz" = (
/obj/structure/table/halflife/no_smooth/large/wood/desk{
	dir = 1
	},
/turf/open/floor/plating/indoor/woodc/wide,
/area/deathmatch)
"Um" = (
/obj/structure/halflife/fence/wire,
/turf/open/floor/plating/ground/sidewalk/inner,
/area/deathmatch)
"Ur" = (
/obj/structure/halflife/tank/chemical/container,
/turf/open/floor/plating/indoor/concrete/bricks,
/area/deathmatch)
"UJ" = (
/obj/machinery/light/small,
/turf/open/floor/plating/indoor/concrete/bricks,
/area/deathmatch)
"Vf" = (
/obj/structure/halflife/floodlight,
/turf/open/floor/plating/indoor/metal/plate,
/area/deathmatch)
"VN" = (
/obj/structure/halflife/trash/papers/three,
/turf/open/floor/plating/indoor/woodc/wide,
/area/deathmatch)
"VT" = (
/obj/structure/halflife/barrel/double/grey,
/turf/open/floor/plating/indoor/concrete/bricks,
/area/deathmatch)
"Wy" = (
/obj/machinery/light/small{
	dir = 4
	},
/turf/open/floor/plating/indoor/concrete/bricks,
/area/deathmatch)
"WE" = (
/obj/structure/flora/bush/fullgrass/style_random,
/turf/open/floor/plating/ground/dirt/alt,
/area/deathmatch)
"Xd" = (
/turf/open/floor/plating/ground/sidewalk,
/area/deathmatch)
"XL" = (
/obj/structure/halflife/road_barrier/concrete/alt,
/turf/open/floor/plating/ground/sidewalk/inner,
/area/deathmatch)
"XT" = (
/obj/structure/halflife/trash/papers/one,
/turf/open/floor/plating/indoor/woodc/wide,
/area/deathmatch)

(1,1,1) = {"
bq
bq
bq
bq
bq
bq
bq
bq
bq
bq
bq
bq
bq
bq
bq
bq
bq
bq
bq
bq
bq
bq
bq
bq
bq
bq
bq
bq
bq
bq
bq
bq
bq
bq
bq
bq
bq
bq
bq
bq
bq
bq
"}
(2,1,1) = {"
bq
QO
QO
QO
QO
QO
QO
QO
QO
QO
QO
QO
QO
QO
QO
QO
QO
QO
QO
QO
QO
QO
QO
QO
QO
QO
QO
QO
QO
QO
QO
QO
QO
QO
QO
QO
QO
QO
QO
QO
QO
bq
"}
(3,1,1) = {"
bq
QO
Ur
gB
BU
BU
QO
bB
Xd
bB
Um
fw
Kz
Kz
Kz
uE
cF
Kz
Kz
vv
QO
BU
jM
QO
NS
BU
BU
BU
BU
KY
BU
BU
BU
jM
QO
BU
BU
Ci
BU
BU
QO
bq
"}
(4,1,1) = {"
bq
QO
Or
JV
BU
tL
QO
vY
lc
bB
Um
fw
cZ
fw
hd
wd
fw
fw
fw
fw
QO
bI
BU
QO
BU
BU
BU
BU
BU
BU
BU
BU
BU
BU
QO
Ci
BU
BU
BU
UJ
QO
bq
"}
(5,1,1) = {"
bq
QO
BU
gB
BU
UJ
QO
bB
Xd
bB
Um
fw
Kz
cZ
fw
Kz
cZ
Kz
hi
Kz
QO
BU
BU
mI
BU
BU
BU
QO
am
BU
BU
BU
BU
BU
BU
BU
BU
BU
BU
Ci
QO
bq
"}
(6,1,1) = {"
bq
QO
BU
gB
BU
BU
QO
bB
Xd
bB
Um
Kz
hd
GG
Kz
Jm
fw
dP
fw
dP
QO
BU
BU
QO
BU
Wy
BU
QO
BU
BU
BU
BU
BU
BU
Wy
BU
BU
BU
BU
Ci
QO
bq
"}
(7,1,1) = {"
bq
QO
Ur
gB
BU
BU
QO
bB
Xd
bB
QO
QO
QO
QO
QO
QO
QO
QO
QO
QO
QO
QT
QT
QO
QO
QO
QO
QO
QO
QO
QO
QO
QO
QO
QO
BU
BU
BU
BU
BU
QO
bq
"}
(8,1,1) = {"
bq
QO
Or
JV
BU
BU
QO
bB
Xd
bB
yq
bB
bB
bB
bB
bB
bB
bB
bB
bB
bB
bB
bB
bB
bB
bB
bB
bB
bB
bB
bB
bB
bB
FS
QO
BU
BU
BU
QO
QO
QO
bq
"}
(9,1,1) = {"
bq
QO
bI
gB
BU
BU
Ds
bB
Xd
Xd
Xd
Xd
Xd
Xd
Xd
Xd
Xd
Xd
Xd
Xd
Xd
Xd
Xd
Xd
Xd
Xd
Xd
Xd
Xd
Xd
Xd
Xd
Xd
qq
QO
BU
BU
BU
NS
NS
QO
bq
"}
(10,1,1) = {"
bq
QO
BU
gB
BU
BU
QO
bB
Xd
bB
bB
bB
bB
bB
FS
Dt
bB
bB
bB
bB
bB
Dt
bB
bB
bB
Dt
bB
bB
bB
bB
Dt
bB
Xd
bB
QO
BU
BU
BU
BU
BU
QO
bq
"}
(11,1,1) = {"
bq
QO
BU
gB
BU
UJ
QO
bB
Xd
bB
QO
QO
QO
QO
QO
QO
QO
QO
QO
QO
QO
QO
QO
QO
QO
QO
QO
QO
QO
QO
QO
bB
Xd
bB
QO
BU
BU
BU
BU
UJ
QO
bq
"}
(12,1,1) = {"
bq
QO
BU
gB
BU
BU
QO
bB
Xd
bB
QO
IR
bZ
yh
QO
bZ
bZ
bZ
QO
bZ
bZ
aV
bZ
QO
bZ
bZ
aV
bZ
bZ
bZ
QO
bB
Xd
bB
QO
BU
BU
BU
BU
BU
QO
bq
"}
(13,1,1) = {"
bq
QO
Ur
gB
BU
Mf
QO
bB
Xd
bB
QO
bZ
bZ
bZ
QO
pl
bZ
bZ
QO
bZ
bZ
bZ
bZ
QO
bZ
bZ
bZ
bZ
VN
bZ
Ds
bB
Xd
bB
QO
BU
BU
QO
am
BU
QO
bq
"}
(14,1,1) = {"
bq
QO
Or
JV
BU
BU
QO
bB
Xd
xl
QO
IR
bZ
bZ
Ds
bZ
bZ
bZ
Ds
bZ
bZ
XT
bZ
bZ
bZ
bZ
bZ
bZ
bZ
bZ
QO
vY
Xd
bB
QO
BU
BU
QO
BU
BU
QO
bq
"}
(15,1,1) = {"
bq
QO
BU
gB
BU
BU
QO
bB
Xd
bB
QO
bZ
Hd
bZ
QO
bZ
bZ
bZ
QO
bZ
bZ
bZ
bZ
bZ
bZ
bZ
bZ
bZ
bZ
bZ
QO
bB
Xd
bB
QO
bI
BU
QO
BU
BU
QO
bq
"}
(16,1,1) = {"
bq
QO
gh
JV
BU
BU
QO
bB
Xd
bB
QO
QO
QO
QO
QO
bZ
bZ
Rz
QO
yp
yp
yp
QO
QO
Oy
bZ
bZ
bZ
bZ
bZ
QO
bB
Xd
bB
mI
BU
BU
QO
am
BU
QO
bq
"}
(17,1,1) = {"
bq
QO
BU
gB
BU
jM
QO
bB
Xd
bB
QO
sj
bZ
bZ
bZ
bZ
bZ
IU
QO
yp
yp
yp
LS
QO
bZ
bZ
bZ
bZ
bZ
IU
QO
bB
Xd
bB
QO
BU
BU
QO
BU
BU
QO
bq
"}
(18,1,1) = {"
bq
QO
Ur
gB
BU
BU
QO
bB
Xd
bB
QO
bZ
bZ
bZ
bZ
bZ
bZ
bZ
QO
yp
yp
yp
yp
QO
Oy
bZ
bZ
bZ
bZ
bZ
QO
bB
Xd
bB
QO
BU
BU
BU
BU
BU
QO
bq
"}
(19,1,1) = {"
bq
QO
Or
JV
BU
UJ
QO
bB
Xd
bB
Ds
bZ
bZ
bZ
bZ
bZ
bZ
Rz
QO
wG
yp
yp
dF
QO
bZ
Hd
bZ
bZ
bZ
yh
QO
bB
Xd
bB
QO
BU
BU
BU
BU
UJ
QO
bq
"}
(20,1,1) = {"
bq
QO
BU
gB
BU
BU
QO
bB
Xd
bB
QO
bZ
bZ
bZ
Hd
bZ
bZ
bZ
QO
yp
yp
yp
QO
QO
QO
QO
QO
JM
QO
QO
QO
bB
Xd
bB
QO
BU
BU
jM
BU
BU
QO
bq
"}
(21,1,1) = {"
bq
QO
gh
JV
BU
OA
QO
bB
Xd
xl
QO
QO
QO
QO
QO
QO
QO
QO
QO
QO
QO
QO
QO
bZ
aV
bZ
bZ
bZ
bZ
aV
QO
vY
Xd
bB
QO
QO
QO
QO
BU
BU
QO
bq
"}
(22,1,1) = {"
bq
QO
bI
gB
BU
BU
QO
bB
Xd
bB
bB
bB
XL
mp
yq
bB
bB
bB
bB
yq
bB
bB
QO
xC
bZ
bZ
bZ
bZ
bZ
bZ
QO
bB
Xd
bB
QO
NS
BU
BU
BU
BU
QO
bq
"}
(23,1,1) = {"
bq
QO
BU
gB
BU
BU
QO
bB
Xd
Xd
Xd
Xd
Xd
Xd
Xd
Xd
Xd
Xd
Xd
Xd
Xd
bB
QO
QO
JM
QO
QO
QO
JM
QO
QO
bB
Xd
bB
QO
NS
BU
BU
BU
BU
QO
bq
"}
(24,1,1) = {"
bq
QO
Ur
gB
BU
BU
QO
bB
bB
bB
bB
bB
bB
bB
bB
XL
bB
bB
bB
bB
Xd
bB
QO
bZ
bZ
bZ
QO
bZ
bZ
bZ
QO
bB
Xd
bB
QO
BU
BU
BU
BU
BU
QO
bq
"}
(25,1,1) = {"
bq
QO
Or
JV
BU
UJ
QO
QO
QO
QO
QO
QO
QO
QO
QO
QO
QO
QO
QO
bB
Xd
bB
QO
pl
bZ
bZ
QO
pl
bZ
bZ
QO
bB
Xd
bB
QO
BU
BU
QO
BU
BU
QO
bq
"}
(26,1,1) = {"
bq
QO
BU
gB
BU
BU
BU
VT
BU
BU
KY
BU
BU
Nb
BU
BU
KY
nv
QO
bB
Xd
bB
QO
ne
eW
bD
QO
bD
eW
EV
QO
bB
Xd
bB
QO
BU
BU
QO
BU
BU
QO
bq
"}
(27,1,1) = {"
bq
QO
BU
gB
BU
BU
BU
BU
BU
BU
BU
BU
BU
BU
BU
BU
BU
BU
QO
bB
Xd
bB
QO
QO
QO
QO
QO
QO
QO
QO
QO
vY
Xd
bB
QO
BU
BU
QO
BU
BU
QO
bq
"}
(28,1,1) = {"
bq
QO
BU
gB
BU
BU
BU
BU
BU
BU
BU
BU
BU
BU
BU
BU
BU
BU
Ds
bB
Xd
bB
yq
XL
bB
bB
bB
yq
bB
bB
bB
bB
Xd
bB
QO
bI
BU
BU
BU
UJ
QO
bq
"}
(29,1,1) = {"
bq
QO
em
ip
BU
BU
BU
BU
BU
BU
BU
BU
BU
BU
BU
BU
BU
sp
QO
bB
Xd
Xd
Xd
Xd
Xd
Xd
Xd
Xd
Xd
Xd
Xd
Xd
Xd
bB
mI
BU
BU
BU
BU
BU
QO
bq
"}
(30,1,1) = {"
bq
QO
BU
BU
BU
BU
BU
Wy
BU
nv
BU
BU
BU
Wy
BU
BU
BU
cg
QO
bB
Xd
bB
bB
bB
bB
bB
bB
bB
XL
bB
bB
bB
bB
bB
QO
BU
BU
BU
BU
BU
QO
bq
"}
(31,1,1) = {"
bq
QO
QO
QO
QO
sN
sN
QO
QO
QO
QO
QO
QO
QO
QO
QO
QO
QO
QO
vY
Xd
bB
QO
QO
QO
QO
QT
QO
QO
QO
QO
QO
QO
QO
QO
BU
BU
QO
QO
QO
QO
bq
"}
(32,1,1) = {"
bq
QO
Ed
sN
EJ
sN
sN
sN
sN
Ed
QO
fw
fw
cF
HN
Kz
Kz
fw
Um
bB
Xd
bB
QO
GP
QO
Ci
BU
KY
BU
BU
BU
BU
QO
BU
BU
BU
BU
BU
BU
sp
QO
bq
"}
(33,1,1) = {"
bq
QO
sN
BU
BU
BU
BU
BU
BU
Ed
QO
aH
Kz
fw
hd
aH
Kz
Kz
Um
bB
Xd
bB
QO
BU
QO
BU
BU
BU
BU
BU
BU
BU
QO
BU
BU
BU
BU
BU
BU
BU
QO
bq
"}
(34,1,1) = {"
bq
QO
Ed
BU
BU
am
BU
NS
BU
sN
JU
GG
fw
fw
Kz
Kz
fw
fw
Um
bB
Xd
bB
QO
bI
BU
BU
BU
BU
BU
QO
BU
BU
KY
BU
BU
BU
BU
BU
BU
BU
QO
bq
"}
(35,1,1) = {"
bq
QO
Vf
BU
BU
BU
BU
NS
BU
sN
JU
aH
Kz
Kz
fw
cZ
WE
fw
Um
bB
Xd
bB
QO
BU
BU
BU
BU
BU
BU
QO
GP
BU
BU
BU
BU
QO
BU
BU
BU
UJ
QO
bq
"}
(36,1,1) = {"
bq
QO
Ed
BU
BU
BU
BU
NS
BU
Aw
QO
dP
Kz
cF
aH
Kz
Kz
Kz
Um
bB
Xd
bB
QO
BU
QO
QO
BU
BU
BU
QO
BU
BU
BU
BU
BU
QO
BU
BU
BU
jM
QO
bq
"}
(37,1,1) = {"
bq
QO
Ed
BU
BU
OA
BU
BU
BU
sN
JU
fw
Kz
Kz
Kz
Kz
fw
Kz
Um
bB
Xd
bB
QO
BU
BU
BU
BU
BU
BU
BU
BU
BU
BU
BU
BU
QO
BU
BU
QO
QO
QO
bq
"}
(38,1,1) = {"
bq
QO
tK
BU
BU
am
BU
BU
BU
Ed
JU
fw
Kz
aH
Kz
hi
hd
fw
Um
bB
Xd
bB
QO
BU
BU
BU
BU
QO
BU
BU
BU
BU
BU
BU
BU
BU
BU
BU
BU
GP
QO
bq
"}
(39,1,1) = {"
bq
QO
sN
BU
BU
BU
BU
BU
BU
sN
QO
Kz
cZ
aH
fw
cZ
wb
fw
Um
bB
Xd
bB
QO
am
jM
BU
am
QO
BU
BU
BU
QO
QO
QO
BU
BU
BU
BU
BU
NS
QO
bq
"}
(40,1,1) = {"
bq
QO
tK
sN
sN
sN
sN
yg
sN
uj
QO
fw
fw
aH
OL
fw
cF
fw
Um
bB
lZ
bB
QO
BU
Wy
BU
BU
QO
Ci
Wy
BU
BU
BU
BU
BU
BU
Wy
BU
BU
NS
QO
bq
"}
(41,1,1) = {"
bq
QO
QO
QO
QO
QO
QO
QO
QO
QO
QO
QO
QO
QO
QO
QO
QO
QO
QO
QO
QO
QO
QO
QO
QO
QO
QO
QO
QO
QO
QO
QO
QO
QO
QO
QO
QO
QO
QO
QO
QO
bq
"}
(42,1,1) = {"
bq
bq
bq
bq
bq
bq
bq
bq
bq
bq
bq
bq
bq
bq
bq
bq
bq
bq
bq
bq
bq
bq
bq
bq
bq
bq
bq
bq
bq
bq
bq
bq
bq
bq
bq
bq
bq
bq
bq
bq
bq
bq
"}
