//MAP CONVERTED BY dmm2tgm.py THIS HEADER COMMENT PREVENTS RECONVERSION, DO NOT REMOVE
"a" = (
/turf/open/floor/plating/ground/brickroad{
	dir = 1
	},
/area/deathmatch)
"b" = (
/turf/open/floor/plating/indoor/woodc/wide,
/area/deathmatch)
"c" = (
/obj/structure/chair/sofa/hl13bench,
/turf/open/misc/grass/jungle/station,
/area/deathmatch)
"f" = (
/turf/open/floor/plating/ground/sidewalk,
/area/deathmatch)
"g" = (
/obj/item/kirbyplants/random,
/turf/open/floor/plating/indoor/woodc/wide,
/area/deathmatch)
"h" = (
/obj/structure/halflife/trash/wood,
/turf/open/misc/grass/jungle/station,
/area/deathmatch)
"i" = (
/obj/effect/landmark/deathmatch_player_spawn,
/turf/open/floor/plating/indoor/woodc/wide,
/area/deathmatch)
"j" = (
/obj/structure/halflife/storage/large/shelf/wood,
/turf/open/floor/plating/indoor/woodc/wide,
/area/deathmatch)
"k" = (
/obj/effect/landmark/deathmatch_player_spawn,
/turf/open/floor/plating/ground/dirt,
/area/deathmatch)
"l" = (
/turf/open/floor/plating/indoor/checkered,
/area/deathmatch)
"m" = (
/obj/effect/turf_decal/siding/thinplating{
	dir = 4
	},
/turf/open/floor/plating/ground/brickroad{
	dir = 1
	},
/area/deathmatch)
"n" = (
/obj/structure/halflife/trash/glass/basic,
/turf/open/floor/plating/indoor/woodc/wide,
/area/deathmatch)
"o" = (
/turf/open/floor/plating/ground/sidewalk/inner,
/area/deathmatch)
"p" = (
/obj/structure/table/halflife/metal/alt,
/obj/item/crowbar/large/heavy,
/turf/open/floor/plating/indoor/woodc/wide,
/area/deathmatch)
"q" = (
/obj/structure/halflife/storage/large/shelf,
/turf/open/floor/plating/indoor/woodc/wide,
/area/deathmatch)
"r" = (
/obj/structure/flora/bush/sparsegrass/style_random,
/turf/open/floor/plating/ground/dirt,
/area/deathmatch)
"s" = (
/obj/effect/light_emitter/fake_outdoors,
/turf/open/floor/plating/ground/brickroad{
	dir = 1
	},
/area/deathmatch)
"t" = (
/obj/structure/halflife/trash/garbage,
/turf/open/floor/plating/ground/dirt,
/area/deathmatch)
"u" = (
/obj/structure/table/halflife/no_smooth/large/wood/desk,
/obj/structure/halflife/trash/papers,
/turf/open/floor/plating/indoor/woodc/wide,
/area/deathmatch)
"w" = (
/obj/machinery/light/cold/directional/south,
/turf/open/floor/plating/indoor/woodc/wide,
/area/deathmatch)
"x" = (
/obj/structure/flora/bush/sparsegrass,
/turf/open/floor/plating/ground/dirt,
/area/deathmatch)
"y" = (
/obj/machinery/light/cold/directional/west,
/turf/open/floor/plating/indoor/woodc/wide,
/area/deathmatch)
"z" = (
/obj/structure/flora/bush/sparsegrass/style_random,
/turf/open/misc/grass/jungle/station,
/area/deathmatch)
"A" = (
/obj/structure/chair/halflife/metal/red{
	dir = 1
	},
/turf/open/floor/plating/indoor/woodc/wide,
/area/deathmatch)
"B" = (
/obj/effect/turf_decal/siding/thinplating{
	dir = 8
	},
/turf/open/floor/plating/ground/brickroad{
	dir = 1
	},
/area/deathmatch)
"C" = (
/obj/structure/window/fulltile,
/turf/open/floor/plating/indoor/woodc/wide,
/area/deathmatch)
"D" = (
/turf/open/misc/grass/jungle/station,
/area/deathmatch)
"E" = (
/obj/effect/light_emitter/fake_outdoors,
/turf/open/floor/plating/ground/dirt,
/area/deathmatch)
"F" = (
/obj/structure/flora/bush/fullgrass/style_random,
/turf/open/floor/plating/ground/dirt,
/area/deathmatch)
"G" = (
/obj/structure/halflife/trash/cardboard,
/turf/open/floor/plating/ground/sidewalk/inner,
/area/deathmatch)
"H" = (
/obj/machinery/door/unpowered/halflife/wood,
/turf/open/floor/plating/indoor/woodc/wide,
/area/deathmatch)
"J" = (
/turf/open/floor/plating/ground/dirt,
/area/deathmatch)
"K" = (
/obj/structure/flora/bush/fullgrass/style_random,
/turf/open/misc/grass/jungle/station,
/area/deathmatch)
"L" = (
/obj/structure/table/halflife/no_smooth/large/wood/square{
	dir = 1
	},
/turf/open/floor/plating/indoor/checkered,
/area/deathmatch)
"M" = (
/obj/structure/halflife/trash/garbage,
/turf/open/floor/plating/ground/sidewalk,
/area/deathmatch)
"O" = (
/turf/closed/indestructible/riveted,
/area/deathmatch)
"P" = (
/turf/closed/wall/halflife/brick,
/area/deathmatch)
"Q" = (
/obj/structure/flora/tree/jungle/small,
/turf/open/floor/plating/ground/dirt,
/area/deathmatch)
"S" = (
/obj/structure/chair/sofa/hl13bench,
/turf/open/floor/plating/ground/dirt,
/area/deathmatch)
"T" = (
/obj/structure/halflife/trash/food/misc,
/turf/open/floor/plating/indoor/checkered,
/area/deathmatch)
"U" = (
/obj/structure/closet/crate/bin,
/turf/open/floor/plating/ground/dirt,
/area/deathmatch)
"V" = (
/obj/structure/table/halflife/metal/alt,
/turf/open/floor/plating/indoor/woodc/wide,
/area/deathmatch)
"W" = (
/obj/structure/flora/bush/sparsegrass,
/turf/open/misc/grass/jungle/station,
/area/deathmatch)
"X" = (
/obj/structure/closet/secure_closet/freezer,
/turf/open/floor/plating/indoor/checkered,
/area/deathmatch)
"Y" = (
/obj/structure/halflife/fence/wire,
/turf/open/floor/plating/ground/dirt,
/area/deathmatch)
"Z" = (
/obj/effect/light_emitter/fake_outdoors,
/turf/open/misc/grass/jungle/station,
/area/deathmatch)

(1,1,1) = {"
O
O
O
O
O
O
O
O
O
O
O
O
O
O
O
O
O
O
O
O
O
O
O
O
O
O
O
O
O
O
"}
(2,1,1) = {"
O
P
P
P
P
P
P
P
P
P
P
P
P
P
P
P
P
P
P
P
P
P
P
P
P
P
P
P
P
O
"}
(3,1,1) = {"
O
P
q
b
y
b
b
g
P
J
J
J
J
J
J
J
J
J
J
J
Y
J
J
J
J
J
J
J
P
O
"}
(4,1,1) = {"
O
P
b
b
b
b
b
b
C
J
W
J
D
D
x
D
J
J
D
D
J
J
D
Q
D
D
D
D
P
O
"}
(5,1,1) = {"
O
P
q
b
b
b
b
b
P
J
D
D
z
J
J
K
D
J
x
J
D
J
J
J
J
J
J
J
P
O
"}
(6,1,1) = {"
O
P
b
b
b
b
b
b
H
J
J
E
D
J
J
D
D
E
J
J
D
D
D
J
E
x
D
J
P
O
"}
(7,1,1) = {"
O
P
b
b
b
b
b
b
P
F
D
D
J
J
z
D
D
D
D
D
J
J
W
J
J
J
J
J
P
O
"}
(8,1,1) = {"
O
P
b
b
P
V
b
b
C
J
D
J
J
F
D
D
D
J
J
J
Y
J
J
D
D
J
Q
D
P
O
"}
(9,1,1) = {"
O
P
b
b
P
V
b
b
P
S
J
J
x
J
J
J
W
J
r
J
Y
J
D
J
F
W
D
D
P
O
"}
(10,1,1) = {"
O
P
b
b
P
V
b
i
P
J
J
D
D
W
W
D
J
J
J
J
Y
k
D
D
D
x
D
J
P
O
"}
(11,1,1) = {"
O
P
P
b
P
P
P
P
P
S
J
J
J
J
J
J
J
J
J
t
P
P
P
P
J
J
D
J
P
O
"}
(12,1,1) = {"
O
P
G
o
o
o
o
o
o
o
o
o
o
o
o
o
o
o
o
o
o
o
o
o
o
o
o
o
P
O
"}
(13,1,1) = {"
O
P
f
f
f
f
f
f
f
f
f
f
f
f
f
f
f
f
f
f
f
f
f
f
f
f
f
f
P
O
"}
(14,1,1) = {"
O
P
B
B
B
B
B
B
B
B
B
B
B
B
B
B
B
B
B
B
B
B
B
B
B
B
B
B
P
O
"}
(15,1,1) = {"
O
P
a
a
s
a
a
a
a
a
a
a
a
a
s
a
a
a
a
a
a
a
a
s
a
a
a
a
P
O
"}
(16,1,1) = {"
O
P
m
m
m
m
m
m
m
m
m
m
m
m
m
m
m
m
m
m
m
m
m
m
m
m
m
m
P
O
"}
(17,1,1) = {"
O
P
M
f
f
f
f
f
f
f
f
f
f
f
f
f
f
f
f
f
f
f
f
f
f
f
f
f
P
O
"}
(18,1,1) = {"
O
P
o
o
o
o
o
o
o
o
o
o
o
o
o
o
o
o
o
o
o
o
o
o
o
o
o
o
P
O
"}
(19,1,1) = {"
O
P
J
J
J
J
J
J
P
P
P
C
C
P
P
K
J
J
J
J
J
U
P
P
P
P
P
P
P
O
"}
(20,1,1) = {"
O
P
J
D
x
J
D
J
P
b
y
b
l
X
P
h
x
J
E
J
J
J
C
u
A
b
b
g
P
O
"}
(21,1,1) = {"
O
P
x
D
J
J
z
J
P
b
b
b
l
l
C
D
J
J
D
D
J
F
C
n
b
b
b
b
P
O
"}
(22,1,1) = {"
O
P
J
J
J
F
D
J
H
b
b
b
l
L
P
c
J
D
D
D
D
J
C
b
b
b
b
w
P
O
"}
(23,1,1) = {"
O
P
F
J
Z
J
D
J
C
b
b
b
l
T
P
J
D
D
J
J
x
J
C
i
b
b
b
b
P
O
"}
(24,1,1) = {"
O
P
J
r
D
J
x
J
P
b
b
b
P
P
P
P
P
P
J
J
J
J
P
P
P
P
P
b
P
O
"}
(25,1,1) = {"
O
P
J
J
D
D
J
J
P
b
b
b
P
b
y
b
i
P
J
F
J
J
J
J
P
b
b
b
P
O
"}
(26,1,1) = {"
O
P
J
Q
D
W
J
F
P
V
b
b
H
b
b
b
b
P
x
J
Z
D
J
J
H
b
b
b
P
O
"}
(27,1,1) = {"
O
P
J
J
J
x
J
J
P
p
b
b
P
b
b
b
V
P
J
J
D
W
x
J
P
j
b
b
P
O
"}
(28,1,1) = {"
O
P
J
x
J
J
k
J
P
V
b
b
P
g
b
V
V
P
k
J
J
J
J
t
P
b
b
b
P
O
"}
(29,1,1) = {"
O
P
P
P
P
P
P
P
P
P
P
P
P
P
P
P
P
P
P
P
P
P
P
P
P
P
P
P
P
O
"}
(30,1,1) = {"
O
O
O
O
O
O
O
O
O
O
O
O
O
O
O
O
O
O
O
O
O
O
O
O
O
O
O
O
O
O
"}
