//MAP CONVERTED BY dmm2tgm.py THIS HEADER COMMENT PREVENTS RECONVERSION, DO NOT REMOVE
"aF" = (
/obj/machinery/light/small{
	dir = 1
	},
/obj/effect/spawner/random/halflife/loot/legendary,
/turf/open/floor/plating/ground/sidewalk/inner,
/area/deathmatch)
"aW" = (
/obj/structure/halflife/barrel/triple/grey,
/turf/open/floor/plating/indoor/concrete/bricks,
/area/deathmatch)
"bw" = (
/turf/closed/indestructible/riveted,
/area/deathmatch)
"bL" = (
/turf/open/floor/plating/indoor/checkered,
/area/deathmatch)
"cB" = (
/obj/machinery/light/small{
	dir = 8
	},
/turf/open/floor/plating/ground/sidewalk/inner,
/area/deathmatch)
"cE" = (
/turf/open/floor/plating/indoor/metal/pipe/intersection{
	dir = 1
	},
/area/deathmatch)
"dc" = (
/obj/machinery/light/small,
/turf/open/floor/plating/ground/sidewalk/inner,
/area/deathmatch)
"dd" = (
/obj/structure/bed/halflife/bedframe/cot,
/obj/structure/bed/halflife/mattress/yellowed,
/turf/open/floor/plating/indoor/carpet,
/area/deathmatch)
"dh" = (
/obj/machinery/light/small{
	dir = 4
	},
/turf/open/floor/plating/ground/sidewalk/inner,
/area/deathmatch)
"dL" = (
/obj/machinery/light/small{
	dir = 1
	},
/turf/open/floor/plating/ground/sidewalk/inner,
/area/deathmatch)
"ed" = (
/obj/structure/halflife/trash/garbage,
/turf/open/floor/plating/ground/dirt/alt,
/area/deathmatch)
"fd" = (
/turf/open/floor/plating/ground/dirt/alt,
/area/deathmatch)
"fK" = (
/obj/structure/halflife/tank/chemical/container,
/turf/open/floor/plating/indoor/metal/pipe{
	dir = 1
	},
/area/deathmatch)
"gp" = (
/turf/open/floor/plating/ground/sidewalk/inner,
/area/deathmatch)
"gN" = (
/obj/machinery/light/small{
	dir = 8
	},
/turf/open/floor/plating/ground/dirt,
/area/deathmatch)
"hg" = (
/obj/machinery/light/small{
	dir = 8
	},
/turf/open/floor/plating/indoor/woodc/wide,
/area/deathmatch)
"hh" = (
/obj/machinery/light/small{
	dir = 4
	},
/turf/open/floor/plating/indoor/metal/plate,
/area/deathmatch)
"hw" = (
/obj/structure/closet/secure_closet/freezer,
/obj/effect/spawner/random/halflife/loot/legendary,
/turf/open/floor/plating/indoor/checkered,
/area/deathmatch)
"ig" = (
/obj/structure/halflife/trash/papers/three,
/turf/open/floor/plating/indoor/woodc/wide,
/area/deathmatch)
"iD" = (
/turf/open/floor/plating/indoor/metal/pipe,
/area/deathmatch)
"iH" = (
/turf/open/floor/plating/ground/dirt,
/area/deathmatch)
"iV" = (
/obj/machinery/light/small{
	dir = 4
	},
/turf/open/floor/plating/ground/dirt,
/area/deathmatch)
"jH" = (
/obj/effect/landmark/deathmatch_player_spawn,
/turf/open/floor/plating/ground/sidewalk/inner,
/area/deathmatch)
"kg" = (
/obj/machinery/light/small,
/turf/open/floor/plating/indoor/concrete/bricks,
/area/deathmatch)
"kv" = (
/obj/machinery/light/small{
	dir = 8
	},
/turf/open/floor/plating/indoor/concrete/bricks,
/area/deathmatch)
"kF" = (
/obj/structure/halflife/trash/cardboard,
/turf/open/floor/plating/indoor/woodc/wide,
/area/deathmatch)
"lG" = (
/obj/structure/table/halflife/no_smooth/wood/stand,
/obj/structure/halflife/trash/food/misc,
/turf/open/floor/plating/indoor/carpet,
/area/deathmatch)
"lL" = (
/obj/effect/spawner/random/halflife/loot/legendary,
/turf/open/floor/plating/indoor/woodc/wide,
/area/deathmatch)
"mX" = (
/turf/open/floor/plating/indoor/metal/pipe{
	dir = 1
	},
/area/deathmatch)
"nB" = (
/obj/structure/halflife/pallet/stack,
/turf/open/floor/plating/indoor/concrete/bricks,
/area/deathmatch)
"oG" = (
/obj/structure/halflife/tank/chemical/huge,
/turf/open/floor/plating/indoor/metal/pipe{
	dir = 1
	},
/area/deathmatch)
"oH" = (
/obj/structure/halflife/storage/large/shelf,
/turf/open/floor/plating/indoor/concrete/bricks,
/area/deathmatch)
"pA" = (
/obj/effect/spawner/random/halflife/loot/legendary,
/turf/open/misc/grass/jungle/station,
/area/deathmatch)
"pZ" = (
/obj/structure/table/halflife/no_smooth/large/wood/square{
	dir = 1
	},
/obj/structure/halflife/trash/food/misc,
/obj/machinery/light/small{
	dir = 8
	},
/turf/open/floor/plating/indoor/checkered,
/area/deathmatch)
"qc" = (
/obj/machinery/door/unpowered/halflife/wood{
	dir = 8
	},
/turf/open/floor/plating/indoor/woodc/wide,
/area/deathmatch)
"ra" = (
/obj/structure/table/halflife/no_smooth/large/wood/desk{
	dir = 1
	},
/turf/open/floor/plating/indoor/woodc/wide,
/area/deathmatch)
"rt" = (
/obj/structure/window/fulltile,
/turf/open/floor/plating/indoor/metal/plate,
/area/deathmatch)
"sg" = (
/obj/effect/landmark/deathmatch_player_spawn,
/turf/open/floor/plating/indoor/concrete/bricks,
/area/deathmatch)
"sp" = (
/obj/machinery/door/unpowered/halflife/wood,
/turf/open/floor/plating/indoor/woodc/wide,
/area/deathmatch)
"tx" = (
/turf/open/floor/plating/indoor/concrete/bricks,
/area/deathmatch)
"tN" = (
/obj/structure/halflife/pallet,
/obj/effect/spawner/random/halflife/loot/legendary,
/turf/open/floor/plating/indoor/concrete/bricks,
/area/deathmatch)
"tS" = (
/obj/structure/halflife/barrel/quadruple/grey/one,
/turf/open/floor/plating/indoor/concrete/bricks,
/area/deathmatch)
"tT" = (
/obj/structure/flora/bush/fullgrass/style_random,
/turf/open/floor/plating/ground/dirt,
/area/deathmatch)
"ua" = (
/obj/structure/halflife/trash/papers/one,
/turf/open/floor/plating/indoor/woodc/wide,
/area/deathmatch)
"uD" = (
/obj/effect/spawner/random/halflife/loot/legendary,
/turf/open/floor/plating/indoor/concrete/bricks,
/area/deathmatch)
"uH" = (
/obj/machinery/power/halflife/streetlamp{
	dir = 8
	},
/turf/open/floor/plating/ground/dirt,
/area/deathmatch)
"vj" = (
/obj/machinery/light/small{
	dir = 4
	},
/obj/effect/landmark/deathmatch_player_spawn,
/turf/open/floor/plating/ground/sidewalk,
/area/deathmatch)
"vy" = (
/obj/structure/halflife/trash/papers/two,
/turf/open/floor/plating/indoor/woodc/wide,
/area/deathmatch)
"vF" = (
/obj/structure/halflife/barrel/double/grey/two,
/turf/open/floor/plating/indoor/concrete/bricks,
/area/deathmatch)
"wX" = (
/obj/machinery/door/unpowered/halflife/wood,
/turf/open/floor/plating/indoor/concrete/bricks,
/area/deathmatch)
"xs" = (
/obj/structure/flora/bush/sparsegrass/style_random,
/turf/open/misc/grass/jungle/station,
/area/deathmatch)
"xX" = (
/obj/structure/halflife/trash/garbage,
/turf/open/floor/plating/ground/dirt,
/area/deathmatch)
"ym" = (
/obj/structure/flora/bush/fullgrass/style_random,
/turf/open/floor/plating/ground/dirt/alt,
/area/deathmatch)
"yp" = (
/obj/structure/table/halflife/no_smooth/large/wood/desk{
	dir = 1
	},
/obj/effect/spawner/random/halflife/loot/legendary,
/turf/open/floor/plating/indoor/woodc/wide,
/area/deathmatch)
"yS" = (
/obj/effect/landmark/deathmatch_player_spawn,
/obj/machinery/light/small,
/turf/open/floor/plating/indoor/metal/plate,
/area/deathmatch)
"AM" = (
/obj/structure/halflife/storage/large/shelf/wood,
/turf/open/floor/plating/indoor/woodc/wide,
/area/deathmatch)
"AW" = (
/obj/effect/spawner/random/halflife/loot/legendary,
/turf/open/floor/plating/ground/dirt,
/area/deathmatch)
"AX" = (
/obj/structure/window/fulltile,
/turf/open/floor/plating/indoor/concrete/bricks,
/area/deathmatch)
"Bh" = (
/obj/structure/flora/tree/jungle/small,
/turf/open/floor/plating/ground/dirt,
/area/deathmatch)
"BR" = (
/obj/structure/halflife/barrel/double/grey/one,
/turf/open/floor/plating/indoor/concrete/bricks,
/area/deathmatch)
"BZ" = (
/obj/structure/halflife/storage/large/shelf,
/obj/effect/spawner/random/halflife/loot/legendary,
/turf/open/floor/plating/indoor/concrete/bricks,
/area/deathmatch)
"Dg" = (
/turf/closed/wall/halflife/brick,
/area/deathmatch)
"Fi" = (
/obj/structure/halflife/storage/large/clothing,
/turf/open/floor/plating/indoor/woodc/wide,
/area/deathmatch)
"Fs" = (
/obj/machinery/light/small{
	dir = 1
	},
/turf/open/floor/plating/indoor/woodc/wide,
/area/deathmatch)
"Fx" = (
/obj/machinery/light/small{
	dir = 1
	},
/turf/open/floor/plating/indoor/concrete/bricks,
/area/deathmatch)
"GJ" = (
/obj/structure/halflife/trash/cardboard,
/turf/open/floor/plating/indoor/concrete/bricks,
/area/deathmatch)
"Hc" = (
/obj/structure/halflife/barrel/triple/red/two,
/turf/open/floor/plating/indoor/concrete/bricks,
/area/deathmatch)
"Hh" = (
/obj/machinery/light/small{
	dir = 4
	},
/turf/open/floor/plating/indoor/concrete/bricks,
/area/deathmatch)
"HH" = (
/obj/effect/landmark/deathmatch_player_spawn,
/turf/open/floor/plating/ground/sidewalk,
/area/deathmatch)
"Iv" = (
/obj/structure/flora/bush/fullgrass/style_random,
/turf/open/misc/grass/jungle/station,
/area/deathmatch)
"IH" = (
/obj/machinery/light/small{
	dir = 4
	},
/turf/open/floor/plating/indoor/woodc/wide,
/area/deathmatch)
"II" = (
/obj/structure/flora/tree/jungle/small,
/turf/open/misc/grass/jungle/station,
/area/deathmatch)
"Jz" = (
/turf/open/floor/plating/indoor/woodc/wide,
/area/deathmatch)
"KA" = (
/obj/effect/spawner/random/halflife/loot/legendary,
/turf/open/floor/plating/ground/sidewalk/inner,
/area/deathmatch)
"KR" = (
/obj/machinery/power/halflife/streetlamp{
	dir = 4
	},
/turf/open/floor/plating/ground/dirt,
/area/deathmatch)
"Mg" = (
/obj/structure/halflife/barrel/triple/red/one,
/turf/open/floor/plating/indoor/concrete/bricks,
/area/deathmatch)
"Ne" = (
/obj/structure/flora/bush/sparsegrass/style_random,
/turf/open/floor/plating/ground/dirt,
/area/deathmatch)
"Nh" = (
/obj/structure/halflife/pallet,
/turf/open/floor/plating/indoor/metal/plate,
/area/deathmatch)
"No" = (
/obj/structure/halflife/road_barrier/concrete/alt,
/turf/open/floor/plating/ground/sidewalk/inner,
/area/deathmatch)
"Og" = (
/obj/effect/spawner/random/halflife/loot/legendary,
/turf/open/floor/plating/indoor/checkered,
/area/deathmatch)
"Pg" = (
/obj/structure/halflife/barrel/double/grey,
/turf/open/floor/plating/indoor/concrete/bricks,
/area/deathmatch)
"PE" = (
/turf/open/floor/plating/indoor/carpet,
/area/deathmatch)
"PK" = (
/obj/effect/landmark/deathmatch_player_spawn,
/turf/open/floor/plating/indoor/woodc/wide,
/area/deathmatch)
"Qr" = (
/turf/open/floor/plating/ground/sidewalk,
/area/deathmatch)
"Qy" = (
/obj/structure/halflife/storage/large/shelf/wood,
/obj/effect/spawner/random/halflife/loot/legendary,
/turf/open/floor/plating/indoor/woodc/wide,
/area/deathmatch)
"QC" = (
/obj/structure/bed/halflife/bedframe/cot,
/obj/structure/bed/halflife/mattress/yellowed,
/obj/effect/spawner/random/halflife/loot/legendary,
/turf/open/floor/plating/indoor/carpet,
/area/deathmatch)
"QE" = (
/turf/open/floor/plating/indoor/metal/pipe/corner{
	dir = 1
	},
/area/deathmatch)
"Ru" = (
/obj/structure/table/halflife/no_smooth/wood/stand,
/obj/effect/spawner/random/halflife/loot/legendary,
/turf/open/floor/plating/indoor/carpet,
/area/deathmatch)
"RZ" = (
/obj/machinery/light/small,
/turf/open/floor/plating/indoor/woodc/wide,
/area/deathmatch)
"Tc" = (
/turf/open/floor/plating/indoor/metal/plate,
/area/deathmatch)
"TC" = (
/obj/structure/halflife/trash/garbage,
/turf/open/floor/plating/indoor/concrete/bricks,
/area/deathmatch)
"TI" = (
/obj/structure/closet/crate/bin,
/obj/effect/spawner/random/halflife/loot/legendary,
/obj/effect/spawner/random/halflife/loot/legendary,
/turf/open/floor/plating/ground/sidewalk/inner,
/area/deathmatch)
"US" = (
/obj/structure/halflife/barrel/triple/grey,
/turf/open/floor/plating/indoor/metal/plate,
/area/deathmatch)
"Vn" = (
/obj/structure/halflife/trash/garbage,
/turf/open/misc/grass/jungle/station,
/area/deathmatch)
"VJ" = (
/turf/open/misc/grass/jungle/station,
/area/deathmatch)
"Wq" = (
/obj/structure/halflife/trash/garbage,
/turf/open/floor/plating/ground/sidewalk/inner,
/area/deathmatch)
"XU" = (
/obj/structure/halflife/floodlight,
/turf/open/floor/plating/indoor/metal/plate,
/area/deathmatch)
"XV" = (
/obj/machinery/light/small{
	dir = 1
	},
/turf/open/floor/plating/indoor/checkered,
/area/deathmatch)
"Yo" = (
/obj/structure/halflife/fence/wire,
/turf/open/floor/plating/ground/sidewalk/inner,
/area/deathmatch)
"YM" = (
/obj/structure/halflife/tank/chemical/container,
/turf/open/floor/plating/indoor/concrete/bricks,
/area/deathmatch)
"YN" = (
/obj/structure/halflife/pallet,
/turf/open/floor/plating/indoor/concrete/bricks,
/area/deathmatch)
"YV" = (
/obj/machinery/light/small{
	dir = 8
	},
/turf/open/floor/plating/indoor/metal/plate,
/area/deathmatch)
"ZM" = (
/obj/structure/halflife/pallet/stack,
/turf/open/floor/plating/indoor/metal/plate,
/area/deathmatch)

(1,1,1) = {"
bw
bw
bw
bw
bw
bw
bw
bw
bw
bw
bw
bw
bw
bw
bw
bw
bw
bw
bw
bw
bw
bw
bw
bw
bw
bw
bw
bw
bw
bw
bw
bw
bw
bw
bw
bw
bw
bw
bw
bw
bw
bw
"}
(2,1,1) = {"
bw
Dg
Dg
Dg
Dg
Dg
Dg
Dg
Dg
Dg
Dg
Dg
Dg
Dg
Dg
Dg
Dg
Dg
Dg
Dg
Dg
Dg
Dg
Dg
Dg
Dg
Dg
Dg
Dg
Dg
Dg
Dg
Dg
Dg
Dg
Dg
Dg
Dg
Dg
Dg
Dg
bw
"}
(3,1,1) = {"
bw
Dg
YM
iD
tx
uD
Dg
gp
Qr
gp
Yo
iH
VJ
VJ
VJ
gN
tT
VJ
VJ
Vn
Dg
tx
sg
Dg
tN
tx
tx
tx
tx
kv
tx
tx
tx
sg
Dg
tx
tx
TC
tx
tx
Dg
bw
"}
(4,1,1) = {"
bw
Dg
mX
cE
tx
Mg
Dg
dL
HH
gp
Yo
iH
Iv
iH
xs
II
iH
iH
iH
iH
Dg
Fx
tx
Dg
tx
tx
tx
tx
tx
tx
tx
tx
tx
tx
Dg
TC
tx
tx
tx
kg
Dg
bw
"}
(5,1,1) = {"
bw
Dg
tx
iD
tx
kg
Dg
gp
Qr
gp
Yo
iH
VJ
Iv
iH
VJ
Iv
VJ
Bh
VJ
Dg
tx
tx
wX
tx
tx
tx
Dg
oH
tx
tx
tx
tx
tx
tx
tx
tx
tx
tx
TC
Dg
bw
"}
(6,1,1) = {"
bw
Dg
tx
iD
tx
tx
Dg
gp
Qr
gp
Yo
VJ
xs
xX
VJ
iV
iH
Ne
iH
Ne
Dg
uD
tx
Dg
tx
Hh
tx
Dg
uD
tx
tx
tx
tx
tx
Hh
tx
tx
tx
tx
TC
Dg
bw
"}
(7,1,1) = {"
bw
Dg
YM
iD
tx
tx
Dg
gp
Qr
KA
Dg
Dg
Dg
Dg
Dg
Dg
Dg
Dg
Dg
Dg
Dg
AX
AX
Dg
Dg
Dg
Dg
Dg
Dg
Dg
Dg
Dg
Dg
Dg
Dg
tx
tx
tx
tx
tx
Dg
bw
"}
(8,1,1) = {"
bw
Dg
mX
cE
tx
tx
Dg
gp
Qr
gp
cB
gp
gp
gp
gp
gp
gp
gp
gp
gp
gp
gp
gp
gp
gp
gp
gp
gp
gp
gp
gp
gp
gp
TI
Dg
tx
tx
tx
Dg
Dg
Dg
bw
"}
(9,1,1) = {"
bw
Dg
Fx
iD
tx
tx
sp
gp
Qr
Qr
Qr
Qr
Qr
Qr
Qr
Qr
Qr
Qr
Qr
Qr
Qr
Qr
Qr
Qr
Qr
Qr
Qr
Qr
Qr
Qr
Qr
Qr
Qr
Wq
Dg
tx
tx
tx
YN
YN
Dg
bw
"}
(10,1,1) = {"
bw
Dg
tx
iD
tx
tx
Dg
gp
Qr
gp
gp
gp
gp
gp
TI
dh
gp
gp
gp
gp
gp
dh
gp
gp
gp
dh
gp
gp
gp
gp
dh
gp
Qr
gp
Dg
tx
tx
tx
tx
tx
Dg
bw
"}
(11,1,1) = {"
bw
Dg
tx
iD
tx
kg
Dg
gp
Qr
gp
Dg
Dg
Dg
Dg
Dg
Dg
Dg
Dg
Dg
Dg
Dg
Dg
Dg
Dg
Dg
Dg
Dg
Dg
Dg
Dg
Dg
gp
Qr
gp
Dg
tx
tx
tx
tx
kg
Dg
bw
"}
(12,1,1) = {"
bw
Dg
tx
iD
tx
tx
Dg
gp
Qr
gp
Dg
Fi
Jz
PK
Dg
Jz
Jz
Jz
Dg
Jz
Jz
hg
Jz
Dg
Jz
Jz
hg
Jz
Jz
Jz
Dg
gp
Qr
gp
Dg
tx
tx
tx
tx
tx
Dg
bw
"}
(13,1,1) = {"
bw
Dg
YM
iD
tx
Hc
Dg
gp
Qr
gp
Dg
Jz
Jz
Jz
Dg
Fs
Jz
Jz
Dg
Jz
Jz
Jz
Jz
Dg
Jz
Jz
Jz
Jz
ig
Jz
sp
gp
Qr
gp
Dg
tx
tx
Dg
BZ
tx
Dg
bw
"}
(14,1,1) = {"
bw
Dg
mX
cE
tx
tx
Dg
gp
Qr
dc
Dg
Fi
Jz
Jz
sp
Jz
Jz
Jz
sp
Jz
Jz
ua
Jz
Jz
Jz
Jz
Jz
Jz
Jz
Jz
Dg
dL
Qr
gp
Dg
tx
tx
Dg
tx
tx
Dg
bw
"}
(15,1,1) = {"
bw
Dg
tx
iD
tx
tx
Dg
gp
Qr
gp
Dg
Jz
IH
Jz
Dg
Jz
Jz
Jz
Dg
Jz
Jz
Jz
Jz
Jz
Jz
Jz
Jz
Jz
Jz
Jz
Dg
gp
Qr
gp
Dg
Fx
tx
Dg
tx
tx
Dg
bw
"}
(16,1,1) = {"
bw
Dg
oG
cE
tx
tx
Dg
gp
Qr
gp
Dg
Dg
Dg
Dg
Dg
Jz
Jz
yp
Dg
bL
bL
bL
Dg
Dg
Qy
Jz
Jz
Jz
Jz
Jz
Dg
gp
Qr
gp
wX
tx
tx
Dg
BZ
tx
Dg
bw
"}
(17,1,1) = {"
bw
Dg
tx
iD
tx
sg
Dg
gp
Qr
gp
Dg
kF
Jz
Jz
Jz
Jz
Jz
RZ
Dg
bL
bL
bL
pZ
Dg
Jz
Jz
Jz
Jz
Jz
RZ
Dg
gp
Qr
gp
Dg
tx
tx
Dg
tx
tx
Dg
bw
"}
(18,1,1) = {"
bw
Dg
YM
iD
tx
tx
Dg
gp
Qr
gp
Dg
Jz
Jz
Jz
Jz
Jz
Jz
Jz
Dg
bL
bL
bL
Og
Dg
AM
Jz
Jz
Jz
Jz
Jz
Dg
gp
Qr
gp
Dg
tx
tx
tx
tx
tx
Dg
bw
"}
(19,1,1) = {"
bw
Dg
mX
cE
tx
kg
Dg
gp
Qr
gp
sp
Jz
Jz
Jz
Jz
Jz
Jz
ra
Dg
XV
bL
bL
hw
Dg
Jz
IH
Jz
Jz
Jz
PK
Dg
gp
Qr
gp
Dg
tx
tx
tx
tx
kg
Dg
bw
"}
(20,1,1) = {"
bw
Dg
tx
iD
tx
uD
Dg
gp
Qr
gp
Dg
Jz
Jz
Jz
IH
Jz
Jz
lL
Dg
bL
bL
bL
Dg
Dg
Dg
Dg
Dg
qc
Dg
Dg
Dg
gp
Qr
gp
Dg
tx
tx
sg
tx
tx
Dg
bw
"}
(21,1,1) = {"
bw
Dg
oG
cE
tx
tS
Dg
gp
Qr
dc
Dg
Dg
Dg
Dg
Dg
Dg
Dg
Dg
Dg
Dg
Dg
Dg
Dg
Jz
hg
Jz
Jz
Jz
Jz
hg
Dg
dL
Qr
gp
Dg
Dg
Dg
Dg
tx
tx
Dg
bw
"}
(22,1,1) = {"
bw
Dg
Fx
iD
tx
tx
Dg
gp
Qr
gp
KA
gp
No
jH
cB
gp
gp
gp
gp
cB
gp
gp
Dg
vy
Jz
Jz
Jz
Jz
Jz
Jz
Dg
gp
Qr
gp
Dg
tN
tx
tx
tx
tx
Dg
bw
"}
(23,1,1) = {"
bw
Dg
tx
iD
tx
tx
Dg
gp
Qr
Qr
Qr
Qr
Qr
Qr
Qr
Qr
Qr
Qr
Qr
Qr
Qr
gp
Dg
Dg
qc
Dg
Dg
Dg
qc
Dg
Dg
gp
Qr
gp
Dg
YN
tx
tx
tx
tx
Dg
bw
"}
(24,1,1) = {"
bw
Dg
YM
iD
tx
tx
Dg
KA
gp
gp
gp
gp
gp
gp
gp
No
gp
gp
gp
gp
Qr
gp
Dg
Jz
Jz
Jz
Dg
Jz
Jz
Jz
Dg
gp
Qr
gp
Dg
tx
tx
tx
tx
tx
Dg
bw
"}
(25,1,1) = {"
bw
Dg
mX
cE
tx
kg
Dg
Dg
Dg
Dg
Dg
Dg
Dg
Dg
Dg
Dg
Dg
Dg
Dg
gp
Qr
gp
Dg
Fs
Jz
Jz
Dg
Fs
Jz
Jz
Dg
gp
Qr
gp
Dg
tx
tx
Dg
tx
tx
Dg
bw
"}
(26,1,1) = {"
bw
Dg
tx
iD
tx
tx
tx
Pg
tx
tx
kv
tx
tx
vF
tx
tx
kv
aW
Dg
gp
Qr
gp
Dg
Ru
dd
PE
Dg
PE
QC
lG
Dg
gp
Qr
gp
Dg
tx
tx
Dg
tx
tx
Dg
bw
"}
(27,1,1) = {"
bw
Dg
tx
iD
tx
tx
tx
tx
tx
tx
tx
tx
tx
tx
tx
tx
tx
tx
Dg
gp
Qr
gp
Dg
Dg
Dg
Dg
Dg
Dg
Dg
Dg
Dg
dL
Qr
gp
Dg
tx
tx
Dg
tx
tx
Dg
bw
"}
(28,1,1) = {"
bw
Dg
uD
iD
tx
tx
tx
tx
tx
tx
tx
tx
tx
tx
tx
tx
tx
tx
sp
gp
Qr
gp
cB
No
gp
gp
gp
cB
gp
gp
gp
gp
Qr
gp
Dg
Fx
tx
tx
tx
kg
Dg
bw
"}
(29,1,1) = {"
bw
Dg
fK
QE
tx
tx
tx
tx
tx
tx
tx
tx
tx
tx
tx
tx
tx
GJ
Dg
gp
Qr
Qr
Qr
Qr
Qr
Qr
Qr
Qr
Qr
Qr
Qr
Qr
Qr
gp
wX
tx
tx
tx
tx
tx
Dg
bw
"}
(30,1,1) = {"
bw
Dg
tx
tx
tx
tx
tx
Hh
tx
aW
uD
tx
tx
Hh
tx
tx
tx
BR
Dg
gp
Qr
gp
gp
gp
gp
gp
gp
gp
No
gp
gp
gp
gp
gp
Dg
tx
tx
tx
tx
tx
Dg
bw
"}
(31,1,1) = {"
bw
Dg
Dg
Dg
Dg
Tc
Tc
Dg
Dg
Dg
Dg
Dg
Dg
Dg
Dg
Dg
Dg
Dg
Dg
aF
Qr
gp
Dg
Dg
Dg
Dg
AX
Dg
Dg
Dg
Dg
Dg
Dg
Dg
Dg
tx
tx
Dg
Dg
Dg
Dg
bw
"}
(32,1,1) = {"
bw
Dg
Nh
Tc
YV
Tc
Tc
Tc
Tc
Nh
Dg
iH
iH
tT
KR
VJ
VJ
iH
Yo
gp
Qr
gp
Dg
nB
Dg
TC
tx
kv
tx
tx
tx
tx
Dg
tx
tx
tx
tx
tx
tx
GJ
Dg
bw
"}
(33,1,1) = {"
bw
Dg
Tc
tx
tx
tx
tx
tx
tx
Nh
Dg
fd
pA
iH
xs
fd
VJ
VJ
Yo
gp
Qr
gp
Dg
tx
Dg
tx
tx
tx
tx
tx
tx
tx
Dg
tx
tx
tx
tx
tx
tx
tx
Dg
bw
"}
(34,1,1) = {"
bw
Dg
Nh
tx
tx
oH
tx
YN
tx
Tc
rt
xX
iH
iH
VJ
VJ
iH
iH
Yo
gp
Qr
gp
Dg
Fx
tx
tx
tx
tx
tx
Dg
tx
tx
kv
tx
tx
tx
tx
tx
tx
tx
Dg
bw
"}
(35,1,1) = {"
bw
Dg
XU
tx
tx
uD
tx
YN
tx
Tc
rt
fd
VJ
VJ
AW
Iv
ym
iH
Yo
gp
Qr
gp
Dg
tx
tx
tx
tx
tx
tx
Dg
nB
tx
tx
tx
tx
Dg
tx
tx
tx
kg
Dg
bw
"}
(36,1,1) = {"
bw
Dg
Nh
tx
tx
tx
tx
YN
tx
yS
Dg
Ne
VJ
tT
fd
VJ
VJ
VJ
Yo
gp
Qr
KA
Dg
tx
Dg
Dg
tx
tx
tx
Dg
tx
tx
tx
tx
tx
Dg
tx
tx
tx
sg
Dg
bw
"}
(37,1,1) = {"
bw
Dg
Nh
tx
tx
tS
tx
tx
tx
Tc
rt
iH
VJ
VJ
VJ
VJ
AW
VJ
Yo
gp
Qr
gp
Dg
tx
tx
tx
tx
tx
tx
tx
tx
tx
tx
tx
tx
Dg
tx
tx
Dg
Dg
Dg
bw
"}
(38,1,1) = {"
bw
Dg
ZM
tx
tx
BZ
tx
tx
tx
Nh
rt
iH
pA
fd
VJ
Bh
xs
iH
Yo
gp
Qr
gp
Dg
tx
tx
tx
tx
Dg
tx
tx
tx
tx
tx
tx
tx
tx
tx
tx
tx
nB
Dg
bw
"}
(39,1,1) = {"
bw
Dg
Tc
tx
tx
tx
tx
tx
tx
Tc
Dg
VJ
Iv
fd
iH
Iv
ed
iH
Yo
gp
Qr
gp
Dg
oH
sg
tx
BZ
Dg
tx
tx
tx
Dg
Dg
Dg
tx
tx
tx
tx
tx
tN
Dg
bw
"}
(40,1,1) = {"
bw
Dg
ZM
Tc
Tc
Tc
Tc
hh
Tc
US
Dg
iH
iH
fd
uH
iH
tT
iH
Yo
gp
vj
gp
Dg
uD
Hh
tx
tx
Dg
TC
Hh
tx
tx
tx
tx
tx
tx
Hh
tx
tx
tN
Dg
bw
"}
(41,1,1) = {"
bw
Dg
Dg
Dg
Dg
Dg
Dg
Dg
Dg
Dg
Dg
Dg
Dg
Dg
Dg
Dg
Dg
Dg
Dg
Dg
Dg
Dg
Dg
Dg
Dg
Dg
Dg
Dg
Dg
Dg
Dg
Dg
Dg
Dg
Dg
Dg
Dg
Dg
Dg
Dg
Dg
bw
"}
(42,1,1) = {"
bw
bw
bw
bw
bw
bw
bw
bw
bw
bw
bw
bw
bw
bw
bw
bw
bw
bw
bw
bw
bw
bw
bw
bw
bw
bw
bw
bw
bw
bw
bw
bw
bw
bw
bw
bw
bw
bw
bw
bw
bw
bw
"}
