//MAP CONVERTED BY dmm2tgm.py THIS HEADER COMMENT PREVENTS RECONVERSION, DO NOT REMOVE
"a" = (
/turf/open/chasm/true/no_smooth/fake_motion_sand/fast,
/area/deathmatch)
"c" = (
/turf/open/floor/plating/indoor/metal/plate,
/area/deathmatch)
"f" = (
/turf/open/floor/plating/indoor/grooved,
/area/deathmatch)
"g" = (
/obj/structure/lattice/catwalk,
/obj/effect/landmark/deathmatch_player_spawn,
/turf/open/chasm/true/no_smooth/fake_motion_sand/fast,
/area/deathmatch)
"j" = (
/obj/structure/chair/comfy/halflife/captain{
	dir = 8
	},
/turf/open/floor/plating/indoor/grooved,
/area/deathmatch)
"k" = (
/obj/structure/closet/crate,
/turf/open/floor/plating/indoor/metal/plate,
/area/deathmatch)
"l" = (
/obj/structure/chair/comfy/halflife/diner{
	dir = 1
	},
/turf/open/floor/plating/indoor/grooved,
/area/deathmatch)
"o" = (
/obj/structure/lattice/catwalk,
/obj/structure/lattice/catwalk,
/turf/open/chasm/true/no_smooth/fake_motion_sand/fast,
/area/deathmatch)
"s" = (
/obj/structure/table/halflife/no_smooth/metal,
/obj/machinery/light/small{
	dir = 8
	},
/turf/open/floor/plating/indoor/grooved,
/area/deathmatch)
"t" = (
/obj/structure/table/halflife/no_smooth/large/metal/desk{
	dir = 8
	},
/turf/open/floor/plating/indoor/metal/plate,
/area/deathmatch)
"u" = (
/obj/machinery/light/small,
/turf/open/floor/plating/indoor/metal/plate,
/area/deathmatch)
"v" = (
/obj/effect/light_emitter/fake_outdoors,
/turf/open/chasm/true/no_smooth/fake_motion_sand/fast,
/area/deathmatch)
"x" = (
/obj/structure/window/reinforced{
	dir = 1
	},
/obj/machinery/power/shuttle_engine/heater,
/turf/open/floor/plating/airless,
/area/deathmatch)
"y" = (
/obj/structure/chair/comfy/halflife/diner{
	dir = 4
	},
/turf/open/floor/plating/indoor/grooved,
/area/deathmatch)
"z" = (
/obj/structure/chair/comfy/halflife/diner,
/turf/open/floor/plating/indoor/grooved,
/area/deathmatch)
"C" = (
/obj/structure/table/halflife/no_smooth/metal,
/turf/open/floor/plating/indoor/grooved,
/area/deathmatch)
"D" = (
/obj/machinery/door/unpowered/halflife/metal,
/turf/open/floor/plating/indoor/metal/plate,
/area/deathmatch)
"G" = (
/obj/machinery/door/unpowered/halflife/seethrough/metal{
	dir = 8
	},
/obj/structure/fans/tiny/invisible,
/turf/open/floor/plating/indoor/grooved,
/area/deathmatch)
"H" = (
/obj/structure/chair/comfy/halflife/captain{
	dir = 4
	},
/turf/open/floor/plating/indoor/grooved,
/area/deathmatch)
"I" = (
/obj/effect/landmark/deathmatch_player_spawn,
/turf/open/floor/plating/indoor/metal/plate,
/area/deathmatch)
"L" = (
/obj/structure/chair/comfy/halflife/diner{
	dir = 8
	},
/turf/open/floor/plating/indoor/grooved,
/area/deathmatch)
"N" = (
/obj/structure/chair/comfy/halflife/diner{
	dir = 8
	},
/obj/machinery/light/small{
	dir = 4
	},
/turf/open/floor/plating/indoor/grooved,
/area/deathmatch)
"O" = (
/turf/closed/wall/halflife/metal,
/area/deathmatch)
"S" = (
/obj/machinery/power/shuttle_engine/propulsion,
/turf/open/floor/plating/airless,
/area/deathmatch)
"V" = (
/obj/machinery/light/small{
	dir = 1
	},
/obj/effect/landmark/deathmatch_player_spawn,
/turf/open/floor/plating/indoor/grooved,
/area/deathmatch)
"W" = (
/obj/structure/lattice/catwalk,
/turf/open/chasm/true/no_smooth/fake_motion_sand/fast,
/area/deathmatch)
"X" = (
/obj/structure/table/halflife/no_smooth/metal,
/obj/machinery/light/small{
	dir = 4
	},
/turf/open/floor/plating/indoor/grooved,
/area/deathmatch)
"Y" = (
/obj/structure/chair/comfy/halflife/diner{
	dir = 4
	},
/obj/machinery/light/small{
	dir = 8
	},
/turf/open/floor/plating/indoor/grooved,
/area/deathmatch)

(1,1,1) = {"
a
a
a
a
a
a
a
a
a
a
a
a
a
a
a
a
a
a
a
a
a
a
a
a
a
a
a
a
a
a
a
a
a
a
a
a
a
a
a
a
a
a
a
a
a
"}
(2,1,1) = {"
a
a
a
a
a
a
a
a
a
a
a
a
a
a
a
a
a
a
a
a
a
a
a
a
a
a
a
a
a
a
a
a
a
a
a
a
a
a
a
a
a
a
a
a
a
"}
(3,1,1) = {"
a
a
a
v
a
a
a
v
a
a
a
v
a
a
a
v
a
a
a
v
a
a
a
v
a
a
a
v
a
a
a
v
a
a
a
v
a
a
a
a
a
a
a
a
a
"}
(4,1,1) = {"
a
a
a
a
a
a
a
a
a
a
a
a
a
a
a
a
a
a
a
a
a
a
a
a
a
a
a
a
a
a
a
a
a
a
a
a
a
a
a
a
a
a
a
a
a
"}
(5,1,1) = {"
a
a
a
a
a
a
a
a
a
a
a
a
a
a
a
a
a
a
a
a
a
a
a
a
a
a
a
a
a
a
a
a
a
a
a
a
a
a
a
a
a
a
a
a
a
"}
(6,1,1) = {"
a
a
a
a
a
a
a
a
a
O
O
O
O
O
G
O
O
O
O
O
G
O
O
O
O
O
O
O
a
a
a
a
a
a
a
a
a
a
a
a
a
a
a
a
a
"}
(7,1,1) = {"
a
a
a
v
a
a
a
v
O
O
C
O
O
y
f
Y
C
y
s
y
f
s
y
O
k
k
O
x
S
a
a
v
a
a
a
v
a
a
a
a
a
a
a
a
a
"}
(8,1,1) = {"
a
a
a
a
a
a
a
a
O
C
j
O
z
c
c
c
c
c
c
c
c
c
c
O
c
c
O
x
S
a
a
a
a
a
a
a
a
a
a
a
a
a
a
a
a
"}
(9,1,1) = {"
a
a
a
a
a
a
a
a
O
V
f
c
c
c
c
l
z
c
l
z
c
c
c
D
c
u
O
x
S
a
a
a
a
a
a
a
a
a
a
a
a
a
a
a
a
"}
(10,1,1) = {"
a
a
a
a
a
a
a
a
O
C
H
O
z
c
c
c
c
c
c
c
c
c
c
O
I
c
O
x
S
a
a
a
a
a
a
a
a
a
a
a
a
a
a
a
a
"}
(11,1,1) = {"
a
a
a
v
a
a
a
v
O
O
C
O
O
L
f
N
C
L
X
L
f
X
L
O
c
t
O
x
S
a
a
v
a
a
a
v
a
a
a
a
a
a
a
a
a
"}
(12,1,1) = {"
a
a
a
a
a
a
a
a
a
O
O
O
O
O
G
O
O
O
O
O
G
O
O
O
O
O
O
O
a
a
a
a
a
a
a
a
a
a
a
a
a
a
a
a
a
"}
(13,1,1) = {"
a
a
a
a
a
a
a
a
a
a
a
o
W
W
W
a
a
v
a
a
W
W
W
W
a
v
a
a
a
a
a
a
a
a
a
a
a
a
a
a
a
a
a
a
a
"}
(14,1,1) = {"
a
a
a
a
a
a
a
a
a
a
W
W
a
a
W
W
W
W
a
a
a
W
a
W
a
a
a
a
a
a
a
a
a
a
a
a
a
a
a
a
a
a
a
a
a
"}
(15,1,1) = {"
a
a
a
v
a
a
a
v
a
a
W
a
O
O
O
O
O
G
O
O
O
O
O
G
O
O
O
O
O
O
O
v
a
a
a
v
a
a
a
a
a
a
a
a
a
"}
(16,1,1) = {"
a
a
a
a
a
a
a
a
a
W
W
O
O
C
O
O
y
f
Y
C
y
s
y
f
s
y
O
k
k
O
x
S
a
a
a
a
a
a
a
a
a
a
a
a
a
"}
(17,1,1) = {"
a
a
a
a
a
a
a
a
W
W
W
O
C
j
O
z
c
c
c
c
c
c
c
c
c
c
O
I
c
O
x
S
a
a
a
a
a
a
a
a
a
a
a
a
a
"}
(18,1,1) = {"
a
a
a
a
a
a
a
a
W
W
g
O
V
f
c
c
c
c
l
z
c
l
z
c
c
c
D
c
u
O
x
S
a
a
a
a
a
a
a
a
a
a
a
a
a
"}
(19,1,1) = {"
a
a
a
v
a
a
a
v
W
W
W
O
C
H
O
z
c
c
c
c
c
c
c
c
c
c
O
c
c
O
x
S
a
a
a
v
a
a
a
a
a
a
a
a
a
"}
(20,1,1) = {"
a
a
a
a
a
a
a
a
a
W
W
O
O
C
O
O
L
f
N
C
L
X
L
f
X
L
O
c
t
O
x
S
a
a
a
a
a
a
a
a
a
a
a
a
a
"}
(21,1,1) = {"
a
a
a
a
a
a
a
a
a
a
W
W
O
O
O
O
O
G
O
O
O
O
O
G
O
O
O
O
O
O
O
a
a
a
a
a
a
a
a
a
a
a
a
a
a
"}
(22,1,1) = {"
a
a
a
a
a
a
a
a
a
a
a
W
W
W
W
W
W
W
a
a
a
W
W
W
a
a
a
a
a
a
a
a
a
a
a
a
a
a
a
a
a
a
a
a
a
"}
(23,1,1) = {"
a
a
a
v
a
a
a
v
a
a
a
a
a
a
a
W
a
v
a
a
a
W
W
W
a
v
a
a
a
a
a
v
a
a
a
v
a
a
a
a
a
a
a
a
a
"}
(24,1,1) = {"
a
a
a
a
a
a
a
a
a
a
O
O
O
O
O
G
O
O
O
O
O
G
O
O
O
O
O
O
O
a
a
a
a
a
a
a
a
a
a
a
a
a
a
a
a
"}
(25,1,1) = {"
a
a
a
a
a
a
a
a
a
O
O
C
O
O
y
f
Y
C
y
s
y
f
s
y
O
k
k
O
x
S
a
a
a
a
a
a
a
a
a
a
a
a
a
a
a
"}
(26,1,1) = {"
a
a
a
a
a
a
a
a
a
O
C
j
O
z
c
c
c
c
c
c
c
c
c
c
O
c
c
O
x
S
a
a
a
a
a
a
a
a
a
a
a
a
a
a
a
"}
(27,1,1) = {"
a
a
a
v
a
a
a
v
a
O
V
f
c
c
c
c
l
z
c
l
z
c
c
c
D
c
u
O
x
S
a
v
a
a
a
v
a
a
a
a
a
a
a
a
a
"}
(28,1,1) = {"
a
a
a
a
a
a
a
a
a
O
C
H
O
z
c
c
c
c
c
c
c
c
c
c
O
c
I
O
x
S
a
a
a
a
a
a
a
a
a
a
a
a
a
a
a
"}
(29,1,1) = {"
a
a
a
a
a
a
a
a
a
O
O
C
O
O
L
f
N
C
L
X
L
f
X
L
O
c
t
O
x
S
a
a
a
a
a
a
a
a
a
a
a
a
a
a
a
"}
(30,1,1) = {"
a
a
a
a
a
a
a
a
a
a
O
O
O
O
O
G
O
O
O
O
O
G
O
O
O
O
O
O
O
a
a
a
a
a
a
a
a
a
a
a
a
a
a
a
a
"}
(31,1,1) = {"
a
a
a
v
a
a
a
v
a
a
a
v
a
a
a
v
a
a
a
v
a
a
a
v
a
a
a
v
a
a
a
v
a
a
a
v
a
a
a
a
a
a
a
a
a
"}
(32,1,1) = {"
a
a
a
a
a
a
a
a
a
a
a
a
a
a
a
a
a
a
a
a
a
a
a
a
a
a
a
a
a
a
a
a
a
a
a
a
a
a
a
a
a
a
a
a
a
"}
(33,1,1) = {"
a
a
a
a
a
a
a
a
a
a
a
a
a
a
a
a
a
a
a
a
a
a
a
a
a
a
a
a
a
a
a
a
a
a
a
a
a
a
a
a
a
a
a
a
a
"}
(34,1,1) = {"
a
a
a
a
a
a
a
a
a
a
a
a
a
a
a
a
a
a
a
a
a
a
a
a
a
a
a
a
a
a
a
a
a
a
a
a
a
a
a
a
a
a
a
a
a
"}
(35,1,1) = {"
a
a
a
a
a
a
a
a
a
a
a
a
a
a
a
a
a
a
a
a
a
a
a
a
a
a
a
a
a
a
a
a
a
a
a
a
a
a
a
a
a
a
a
a
a
"}
