//MAP CONVERTED BY dmm2tgm.py THIS HEADER COMMENT PREVENTS RECONVERSION, DO NOT REMOVE
"a" = (
/turf/open/misc/beach/sand,
/area/deathmatch)
"c" = (
/obj/structure/halflife/tank,
/turf/open/misc/beach/sand,
/area/deathmatch)
"f" = (
/turf/closed/indestructible/riveted,
/area/deathmatch)
"h" = (
/turf/open/floor/plating/indoor/woodc/wide,
/area/deathmatch)
"j" = (
/obj/structure/halflife/pallet,
/obj/structure/halflife/trash/food/dinner,
/turf/open/misc/beach/sand,
/area/deathmatch)
"l" = (
/obj/structure/halflife/trash/garbage,
/turf/open/floor/plating/indoor/woodc/wide,
/area/deathmatch)
"m" = (
/obj/structure/spawner/halflife/antlion,
/turf/open/misc/beach/sand,
/area/deathmatch)
"n" = (
/obj/structure/halflife/road_barrier/concrete{
	dir = 8
	},
/turf/open/misc/beach/sand,
/area/deathmatch)
"o" = (
/obj/structure/railing/halflife/wood/single,
/turf/open/misc/beach/sand,
/area/deathmatch)
"q" = (
/obj/structure/halflife/fence,
/turf/open/misc/beach/sand,
/area/deathmatch)
"r" = (
/obj/structure/halflife/trash/glass/plate,
/turf/open/misc/beach/sand,
/area/deathmatch)
"s" = (
/obj/structure/halflife/road_barrier,
/turf/open/misc/beach/sand,
/area/deathmatch)
"t" = (
/obj/effect/landmark/deathmatch_player_spawn,
/turf/open/floor/plating/indoor/woodc/wide,
/area/deathmatch)
"v" = (
/obj/structure/halflife/trash/books,
/turf/open/misc/beach/sand,
/area/deathmatch)
"w" = (
/obj/structure/halflife/trash/wood,
/turf/open/misc/beach/sand,
/area/deathmatch)
"x" = (
/obj/structure/halflife/trash/papers/one,
/turf/open/misc/beach/sand,
/area/deathmatch)
"y" = (
/obj/structure/halflife/trash/garbage,
/turf/open/misc/beach/sand,
/area/deathmatch)
"z" = (
/obj/effect/landmark/deathmatch_player_spawn,
/turf/open/misc/beach/sand,
/area/deathmatch)
"A" = (
/obj/structure/halflife/trash/bricks,
/turf/open/misc/beach/sand,
/area/deathmatch)
"B" = (
/turf/cordon,
/area/deathmatch)
"D" = (
/obj/structure/halflife/trash/books/pile_alt,
/turf/open/misc/beach/sand,
/area/deathmatch)
"E" = (
/obj/structure/halflife/pallet,
/turf/open/misc/beach/sand,
/area/deathmatch)
"F" = (
/obj/effect/light_emitter/fake_outdoors,
/turf/open/misc/beach/sand,
/area/deathmatch)
"G" = (
/obj/structure/halflife/trash/cardboard,
/turf/open/misc/beach/sand,
/area/deathmatch)
"H" = (
/obj/structure/halflife/trash/papers,
/turf/open/floor/plating/indoor/woodc/wide,
/area/deathmatch)
"J" = (
/obj/structure/halflife/trash/food/misc,
/turf/open/floor/plating/indoor/woodc/wide,
/area/deathmatch)
"K" = (
/turf/closed/wall/halflife/wood,
/area/deathmatch)
"L" = (
/obj/structure/halflife/trash/papers/two,
/turf/open/misc/beach/sand,
/area/deathmatch)
"P" = (
/obj/structure/halflife/trash/glass/basic,
/turf/open/misc/beach/sand,
/area/deathmatch)
"Q" = (
/obj/structure/halflife/trash/papers/three,
/turf/open/misc/beach/sand,
/area/deathmatch)
"R" = (
/turf/open/floor/holofloor/beach/water,
/area/deathmatch)
"U" = (
/obj/effect/light_emitter/fake_outdoors,
/turf/open/floor/holofloor/beach/water,
/area/deathmatch)
"V" = (
/obj/structure/halflife/trash/glass/cans,
/turf/open/misc/beach/sand,
/area/deathmatch)

(1,1,1) = {"
f
f
f
f
f
f
f
f
f
f
f
f
f
f
f
f
f
f
f
f
f
f
f
f
f
f
f
f
f
f
"}
(2,1,1) = {"
f
B
B
B
B
B
B
B
B
B
B
B
B
B
B
B
B
B
B
B
B
B
B
B
B
B
B
B
B
f
"}
(3,1,1) = {"
f
B
a
a
a
a
a
a
a
a
a
a
a
a
a
a
a
a
a
a
a
a
a
a
a
a
a
a
B
f
"}
(4,1,1) = {"
f
B
a
a
a
a
G
a
a
a
a
a
a
a
a
a
a
a
a
a
a
a
K
K
K
a
a
a
B
f
"}
(5,1,1) = {"
f
B
a
a
a
a
a
a
a
a
a
a
a
a
a
a
a
a
P
a
a
a
K
a
a
a
a
a
B
f
"}
(6,1,1) = {"
f
B
a
a
F
a
a
a
a
a
F
a
a
a
a
F
a
a
a
a
F
a
K
n
a
a
F
a
B
f
"}
(7,1,1) = {"
f
B
a
a
a
a
a
a
a
a
a
a
a
a
a
a
a
a
a
a
a
a
a
a
a
a
a
a
B
f
"}
(8,1,1) = {"
f
B
a
a
a
a
a
a
a
a
a
Q
a
a
a
a
a
a
a
a
a
a
a
a
a
a
a
a
B
f
"}
(9,1,1) = {"
f
B
a
a
K
a
a
a
a
a
a
a
a
a
a
a
a
a
a
a
a
a
a
a
K
z
a
a
B
f
"}
(10,1,1) = {"
f
B
a
a
a
K
a
a
a
a
a
a
a
a
a
a
a
a
A
a
a
a
a
a
K
K
a
a
B
f
"}
(11,1,1) = {"
f
B
a
a
a
s
a
a
o
a
a
a
v
a
a
a
a
a
a
a
a
a
a
a
a
K
a
a
B
f
"}
(12,1,1) = {"
f
B
a
a
F
a
a
a
o
a
F
a
a
a
a
F
a
a
a
a
F
a
a
a
a
K
K
a
B
f
"}
(13,1,1) = {"
f
B
a
a
a
a
a
z
K
w
a
a
a
a
a
a
a
a
a
a
a
a
a
a
a
a
w
a
B
f
"}
(14,1,1) = {"
f
B
a
a
a
a
a
K
K
j
a
a
a
a
a
a
V
a
a
a
a
a
a
a
a
a
a
a
B
f
"}
(15,1,1) = {"
f
B
a
a
a
a
y
a
q
a
a
m
a
a
a
a
a
a
a
a
a
a
E
a
a
a
a
a
B
f
"}
(16,1,1) = {"
f
B
a
a
a
a
a
a
a
a
a
a
a
a
a
a
a
y
a
a
a
a
a
a
a
a
a
a
B
f
"}
(17,1,1) = {"
f
B
a
a
a
a
a
a
a
a
a
a
a
a
a
a
a
a
a
a
a
a
a
a
a
a
a
a
B
f
"}
(18,1,1) = {"
f
B
a
a
F
a
a
a
a
a
F
a
a
a
a
F
a
a
a
a
F
a
a
a
a
a
F
a
B
f
"}
(19,1,1) = {"
f
B
a
P
a
a
a
a
a
a
a
a
a
a
a
a
a
a
a
a
a
a
m
a
a
a
a
a
B
f
"}
(20,1,1) = {"
f
B
a
a
a
a
a
a
a
a
a
a
a
a
a
a
a
a
a
a
a
a
Q
a
a
a
a
a
B
f
"}
(21,1,1) = {"
f
B
a
a
a
a
a
a
a
a
a
a
a
y
a
a
a
a
a
a
L
a
a
a
a
a
a
a
B
f
"}
(22,1,1) = {"
f
B
a
a
a
a
a
a
a
a
a
a
a
a
a
a
a
a
a
a
a
a
a
a
a
y
a
a
B
f
"}
(23,1,1) = {"
f
B
a
a
a
a
a
a
a
a
a
a
a
a
a
a
a
a
a
a
a
a
a
a
a
K
K
a
B
f
"}
(24,1,1) = {"
f
B
a
a
F
m
x
a
a
a
F
a
a
a
a
F
a
a
a
a
F
a
a
a
a
o
F
a
B
f
"}
(25,1,1) = {"
f
B
a
a
a
a
a
a
a
a
a
a
a
G
a
a
a
a
a
a
a
a
a
a
a
o
a
z
B
f
"}
(26,1,1) = {"
f
B
a
a
a
r
a
a
a
a
a
a
a
a
a
a
a
a
a
a
a
a
a
a
a
o
a
a
B
f
"}
(27,1,1) = {"
f
B
y
a
a
a
a
a
a
a
a
a
a
a
a
a
a
a
a
a
a
a
a
w
a
a
a
a
B
f
"}
(28,1,1) = {"
f
B
a
a
a
a
Q
a
a
a
a
a
a
a
a
a
a
a
A
a
a
a
a
a
a
a
a
a
B
f
"}
(29,1,1) = {"
f
B
a
a
a
a
a
a
a
a
a
a
a
a
a
a
a
a
a
a
a
a
a
a
a
a
a
a
B
f
"}
(30,1,1) = {"
f
B
a
a
F
a
a
a
c
y
F
a
c
a
a
F
a
a
a
a
F
a
a
a
a
a
F
a
B
f
"}
(31,1,1) = {"
f
B
a
a
a
a
a
K
K
K
K
K
K
s
a
a
a
a
a
a
a
a
a
a
a
a
a
a
B
f
"}
(32,1,1) = {"
f
B
a
a
a
a
a
K
a
a
h
t
K
a
a
a
a
a
a
m
a
a
a
a
a
a
a
a
B
f
"}
(33,1,1) = {"
f
B
a
a
a
a
E
K
w
a
a
h
K
a
a
a
a
a
a
a
a
a
a
a
a
a
a
a
B
f
"}
(34,1,1) = {"
f
B
a
a
a
a
a
K
h
a
a
a
a
a
a
a
a
a
a
a
a
a
a
a
a
a
a
a
B
f
"}
(35,1,1) = {"
f
B
a
a
a
a
w
K
J
h
a
a
K
a
a
a
a
a
a
a
a
a
a
a
w
a
a
y
B
f
"}
(36,1,1) = {"
f
B
a
a
F
a
z
K
a
h
H
a
K
a
a
F
a
a
a
a
F
a
E
E
a
a
F
a
B
f
"}
(37,1,1) = {"
f
B
R
a
a
a
a
K
K
K
K
K
K
D
a
a
a
a
a
a
a
a
a
a
K
K
K
a
B
f
"}
(38,1,1) = {"
f
B
R
a
a
a
a
a
a
a
a
a
a
h
h
a
a
a
a
a
a
a
w
K
a
P
a
R
B
f
"}
(39,1,1) = {"
f
B
R
R
a
a
R
a
a
a
R
a
a
h
h
a
a
a
a
a
a
a
a
a
a
a
a
R
B
f
"}
(40,1,1) = {"
f
B
R
R
R
R
R
R
R
R
R
R
R
h
h
R
a
R
R
R
R
a
a
a
a
z
R
R
B
f
"}
(41,1,1) = {"
f
B
R
R
R
R
R
R
R
R
R
R
R
h
h
R
R
R
R
R
R
R
R
R
R
a
R
R
B
f
"}
(42,1,1) = {"
f
B
R
R
U
R
R
R
R
R
U
R
R
h
h
U
R
R
R
R
U
R
R
R
R
R
U
R
B
f
"}
(43,1,1) = {"
f
B
R
R
R
R
R
R
R
R
R
R
R
h
h
R
R
R
R
R
R
R
R
R
R
R
R
R
B
f
"}
(44,1,1) = {"
f
B
R
R
R
R
R
R
R
R
R
R
R
h
h
R
R
R
R
R
R
R
R
R
R
R
R
R
B
f
"}
(45,1,1) = {"
f
B
R
R
R
R
R
R
R
R
R
R
R
h
l
R
R
R
R
R
R
R
R
R
R
R
R
R
B
f
"}
(46,1,1) = {"
f
B
R
R
R
R
R
R
R
R
R
R
R
h
h
R
R
R
R
R
R
R
R
R
R
R
R
R
B
f
"}
(47,1,1) = {"
f
B
R
R
R
R
R
R
R
R
R
R
R
R
R
R
R
R
R
R
R
R
R
R
R
R
R
R
B
f
"}
(48,1,1) = {"
f
B
R
R
U
R
R
R
R
R
U
R
R
R
R
U
R
R
R
R
U
R
R
R
R
R
U
R
B
f
"}
(49,1,1) = {"
f
B
B
B
B
B
B
B
B
B
B
B
B
B
B
B
B
B
B
B
B
B
B
B
B
B
B
B
B
f
"}
(50,1,1) = {"
f
f
f
f
f
f
f
f
f
f
f
f
f
f
f
f
f
f
f
f
f
f
f
f
f
f
f
f
f
f
"}
