//MAP CONVERTED BY dmm2tgm.py THIS HEADER COMMENT PREVENTS RECONVERSION, DO NOT REMOVE
"a" = (
/obj/machinery/power/shuttle_engine/propulsion,
/turf/open/floor/plating/indoor/metal/plate,
/area/shuttle/arrival)
"c" = (
/obj/machinery/light/small{
	dir = 1
	},
/turf/open/floor/plating/indoor/metal/plate,
/area/shuttle/arrival)
"d" = (
/obj/machinery/light/small{
	dir = 8
	},
/obj/structure/table/halflife/no_smooth/metal,
/turf/open/floor/plating/indoor/grooved,
/area/shuttle/arrival)
"l" = (
/obj/structure/chair/comfy/halflife/diner{
	dir = 4
	},
/turf/open/floor/plating/indoor/grooved,
/area/shuttle/arrival)
"m" = (
/turf/closed/wall/halflife/metal,
/area/shuttle/arrival)
"s" = (
/obj/machinery/door/unpowered/halflife/seethrough/metal{
	dir = 8
	},
/obj/structure/fans/tiny/invisible,
/turf/open/floor/plating/indoor/grooved,
/area/shuttle/arrival)
"v" = (
/obj/structure/table/halflife/no_smooth/metal,
/turf/open/floor/plating/indoor/grooved,
/area/shuttle/arrival)
"w" = (
/obj/structure/window/fulltile,
/turf/open/floor/plating/indoor/metal/plate,
/area/shuttle/arrival)
"x" = (
/obj/docking_port/mobile/arrivals{
	dir = 2;
	name = "box arrivals shuttle"
	},
/turf/closed/wall/halflife/metal,
/area/shuttle/arrival)
"z" = (
/obj/structure/table/halflife/no_smooth/metal,
/obj/machinery/light/small{
	dir = 4
	},
/turf/open/floor/plating/indoor/grooved,
/area/shuttle/arrival)
"B" = (
/obj/machinery/power/shuttle_engine/heater,
/obj/structure/window/reinforced{
	dir = 1
	},
/turf/open/floor/plating/indoor/metal/plate,
/area/shuttle/arrival)
"H" = (
/turf/template_noop,
/area/space)
"J" = (
/turf/template_noop,
/area/shuttle/arrival)
"L" = (
/obj/machinery/light/small,
/turf/open/floor/plating/indoor/metal/plate,
/area/shuttle/arrival)
"M" = (
/obj/structure/chair/comfy/halflife/diner{
	dir = 8
	},
/turf/open/floor/plating/indoor/grooved,
/area/shuttle/arrival)
"T" = (
/turf/open/floor/plating/indoor/metal/plate,
/area/shuttle/arrival)
"U" = (
/obj/machinery/light/small{
	dir = 4
	},
/obj/structure/table/halflife/no_smooth/metal,
/turf/open/floor/plating/indoor/grooved,
/area/shuttle/arrival)
"W" = (
/turf/open/floor/plating/indoor/grooved,
/area/shuttle/arrival)

(1,1,1) = {"
H
m
m
w
m
m
s
m
m
w
m
m
B
a
"}
(2,1,1) = {"
m
m
v
l
d
l
W
l
d
v
l
m
m
J
"}
(3,1,1) = {"
x
c
T
T
T
T
T
T
T
T
T
L
m
J
"}
(4,1,1) = {"
m
m
v
M
z
M
W
M
U
v
M
m
m
J
"}
(5,1,1) = {"
H
m
m
w
m
m
s
m
m
w
m
m
B
a
"}
