//MAP CONVERTED BY dmm2tgm.py THIS HEADER COMMENT PREVENTS RECONVERSION, DO NOT REMOVE
"b" = (
/turf/closed/wall/halflife/metal,
/area/shuttle/supply)
"e" = (
/turf/open/floor/plating/indoor/metal/combine,
/area/shuttle/supply)
"g" = (
/obj/machinery/door/unpowered/halflife/metal{
	dir = 8
	},
/obj/structure/fans/tiny/invisible,
/turf/open/floor/plating/indoor/metal/combine,
/area/shuttle/supply)
"i" = (
/obj/docking_port/mobile/supply,
/obj/machinery/door/unpowered/halflife/metal{
	dir = 8
	},
/obj/structure/fans/tiny/invisible,
/turf/open/floor/plating/indoor/metal/combine,
/area/shuttle/supply)
"j" = (
/obj/machinery/light/directional/west,
/turf/open/floor/plating/indoor/metal/combine,
/area/shuttle/supply)
"p" = (
/obj/structure/window/reinforced/spawner/directional/north,
/obj/machinery/power/shuttle_engine/heater,
/turf/open/floor/plating/airless,
/area/shuttle/supply)
"s" = (
/turf/template_noop,
/area/template_noop)
"t" = (
/obj/machinery/power/shuttle_engine/propulsion/burst/left,
/turf/open/floor/plating/airless,
/area/shuttle/supply)
"u" = (
/obj/machinery/power/shuttle_engine/propulsion,
/turf/open/floor/plating/airless,
/area/shuttle/supply)
"v" = (
/obj/machinery/power/shuttle_engine/propulsion/burst/right,
/turf/open/floor/plating/airless,
/area/shuttle/supply)

(1,1,1) = {"
b
b
b
b
b
b
b
b
s
"}
(2,1,1) = {"
b
e
j
e
e
e
b
b
t
"}
(3,1,1) = {"
b
e
e
e
e
e
e
p
u
"}
(4,1,1) = {"
b
e
e
e
e
e
e
p
u
"}
(5,1,1) = {"
b
e
e
e
e
e
e
p
u
"}
(6,1,1) = {"
b
e
e
e
e
e
b
b
v
"}
(7,1,1) = {"
b
g
b
i
b
b
b
b
s
"}
