//MAP CONVERTED BY dmm2tgm.py THIS HEADER COMMENT PREVENTS RECONVERSION, DO NOT REMOVE
"a" = (
/turf/template_noop,
/area/template_noop)
"b" = (
/obj/structure/chair/comfy/halflife/captain{
	dir = 1
	},
/turf/open/floor/plating/indoor/metal/combine,
/area/shuttle/transport)
"e" = (
/obj/machinery/power/shuttle_engine/propulsion/left{
	dir = 8
	},
/turf/open/floor/plating/airless,
/area/shuttle/transport)
"g" = (
/obj/structure/chair/comfy/halflife/captain,
/turf/open/floor/plating/indoor/metal/combine,
/area/shuttle/transport)
"i" = (
/obj/machinery/light/directional/south,
/turf/open/floor/plating/indoor/metal/combine,
/area/shuttle/transport)
"k" = (
/obj/machinery/light/small/directional/west,
/turf/open/floor/plating/indoor/metal/combine,
/area/shuttle/transport)
"l" = (
/turf/open/floor/plating/indoor/metal/combine,
/area/shuttle/transport)
"m" = (
/obj/machinery/computer/shuttle/ferry/request{
	dir = 8
	},
/turf/open/floor/plating/indoor/metal/combine,
/area/shuttle/transport)
"n" = (
/obj/docking_port/mobile{
	dir = 8;
	shuttle_id = "ferry";
	name = "ferry shuttle";
	preferred_direction = 4;
	train = TRUE
	},
/turf/closed/wall/halflife/metal,
/area/shuttle/transport)
"r" = (
/turf/closed/wall/halflife/metal,
/area/shuttle/transport)
"H" = (
/obj/machinery/door/airlock/highsecurity/combine,
/obj/structure/fans/tiny/invisible,
/turf/open/floor/plating/indoor/metal/combine,
/area/shuttle/transport)

(1,1,1) = {"
a
a
a
a
a
"}
(2,1,1) = {"
r
e
r
e
r
"}
(3,1,1) = {"
r
r
r
r
r
"}
(4,1,1) = {"
r
g
k
b
r
"}
(5,1,1) = {"
r
g
l
b
r
"}
(6,1,1) = {"
r
g
l
b
r
"}
(7,1,1) = {"
r
g
l
b
r
"}
(8,1,1) = {"
H
l
l
l
H
"}
(9,1,1) = {"
r
l
l
i
r
"}
(10,1,1) = {"
H
l
l
l
H
"}
(11,1,1) = {"
r
g
l
b
r
"}
(12,1,1) = {"
r
r
m
r
r
"}
(13,1,1) = {"
a
r
n
r
a
"}
